YYMM;YY;MM;Regions;Consommation;Thermique;Nucleaire;Eolien;Solaire;Hydraulique;Pompage;Bioenergies;Production;Renouvelable;Balance
1301;13;1;AURA;14455649;565977;19264589;130835;27494;6070182;-612641;103065;25549501;5718935;11093852
1301;13;1;B;5055739;94521;0;235349;7645;112716;-8719;25014;466526;372005;-4589213
1301;13;1;BFC;4704866;487702;0;42601;4347;241036;-6;20181;795861;308159;-3909005
1301;13;1;CVDL;4418962;142685;15413978;243996;6996;47386;0;33722;15888763;332100;11469801
1301;13;1;GE;9732409;3041047;14501127;550854;14825;1621295;-230275;87938;19586811;2044637;9854402
1301;13;1;HF;11056438;1655356;7314899;533164;2851;1486;0;103008;9610764;640509;-1445674
1301;13;1;IDF;16826536;1511681;0;5861;1614;86;0;187515;1706757;195076;-15119779
1301;13;1;N;6496893;1359372;14923798;172793;3332;28783;0;75817;16563895;280725;10067002
1301;13;1;NlleA;9828102;378586;9591748;121825;47028;929447;0;202623;11271257;1300923;1443155
1301;13;1;O;8618360;153116;3698196;415368;68410;2409534;-353245;107533;6498912;2647600;-2119448
1301;13;1;PACA;9198006;1551131;0;24333;76094;2153863;-58;93777;3899140;2348009;-5298866
1301;13;1;PDL;6123395;1634777;0;150847;14908;2323;0;49781;1852636;217859;-4270759
1302;13;2;AURA;13605248;475746;16616815;131009;41655;5598065;-443817;82818;22502291;5409730;8897043
1302;13;2;B;4638212;86293;0;245074;14435;94298;-7040;24885;457945;371652;-4180267
1302;13;2;BFC;4406255;420302;0;49090;10603;247337;0;18512;745844;325542;-3660411
1302;13;2;CVDL;4141006;116908;13980033;299844;14658;53641;0;32163;14497247;400306;10356241
1302;13;2;GE;9179833;3744943;12169521;664312;28165;1410734;-178145;79225;17918755;2004291;8738922
1302;13;2;HF;10060859;1613401;5912332;566387;8029;1339;0;91135;8192623;666890;-1868236
1302;13;2;IDF;15613449;1342749;0;6789;4251;8;0;173797;1527594;184845;-14085855
1302;13;2;N;6028259;1363271;12634684;177160;7393;21810;0;70974;14275292;277337;8247033
1302;13;2;NlleA;8963998;321708;8744393;139551;84816;1139804;0;185632;10615904;1549803;1651906
1302;13;2;O;7752824;111573;3421011;416915;106364;2791829;-316515;92861;6624038;3091454;-1128786
1302;13;2;PACA;8547998;1289123;0;23479;92626;2166880;-31;84599;3656676;2367553;-4891322
1302;13;2;PDL;5721150;1813103;0;191716;28794;2586;0;44853;2081052;267949;-3640098
1303;13;3;AURA;13293588;437527;16343857;124316;68253;5148910;-609377;101623;21615109;4833725;8321521
1303;13;3;B;4913508;95224;0;239614;20449;99640;-6859;26773;474841;379617;-4438667
1303;13;3;BFC;4383280;417864;0;42604;19835;167134;0;20933;668370;250506;-3714910
1303;13;3;CVDL;4067202;125727;13686620;251326;23267;31671;0;40535;14159146;346799;10091944
1303;13;3;GE;9396491;3395135;13434720;631826;59101;1388330;-223574;91441;18776979;1947124;9380488
1303;13;3;HF;10490636;1539762;5188136;549111;13566;1499;0;100278;7392352;664454;-3098284
1303;13;3;IDF;15582496;1544133;0;5255;7519;5987;0;176462;1739356;195223;-13843140
1303;13;3;N;6290628;1409635;12573897;145041;10637;30351;0;70005;14239566;256034;7948938
1303;13;3;NlleA;8653280;317297;8803136;132861;135957;909294;0;213795;10512340;1391907;1859060
1303;13;3;O;7378251;173080;3597812;373913;152131;2863556;-360601;106655;6906546;3135654;-471705
1303;13;3;PACA;8274568;1511287;0;21199;113023;2064457;0;63917;3773883;2262596;-4500685
1303;13;3;PDL;5768445;1622580;0;172555;42423;2940;0;55102;1895600;273020;-3872845
1304;13;4;AURA;10929625;78801;14807580;110378;78654;5880660;-699034;76124;20333163;5446782;9403538
1304;13;4;B;4030591;3678;0;333355;32531;82488;-5083;21459;468428;464750;-3562163
1304;13;4;BFC;3590999;66106;0;50391;27851;191059;-68;14909;350248;284142;-3240751
1304;13;4;CVDL;3216031;12600;10903923;270265;34381;45377;0;24622;11291168;374645;8075137
1304;13;4;GE;7774641;1807523;13309418;724457;82900;1664627;-212058;59514;17436381;2319440;9661740
1304;13;4;HF;8692895;838290;4323201;599783;23934;1444;0;78202;5864854;703363;-2828041
1304;13;4;IDF;12457808;395202;0;6476;12393;7542;0;153217;574830;179628;-11882978
1304;13;4;N;5076206;917648;10600232;185333;19618;27482;0;66770;11817083;299203;6740877
1304;13;4;NlleA;7083239;72427;5544436;112438;164146;1016194;0;179814;7089455;1472592;6216
1304;13;4;O;6042499;2132;3449599;365283;171575;2737434;-168785;70351;6627589;3175858;585090
1304;13;4;PACA;6647242;978766;0;13816;128395;2580432;-488;57435;3758356;2779590;-2888886
1304;13;4;PDL;4727256;909280;0;191962;62781;3246;0;44142;1211411;302131;-3515845
1305;13;5;AURA;10247670;44056;15047708;112269;101820;7467792;-693357;92089;22172377;7080613;11924707
1305;13;5;B;3362309;3578;0;228230;35751;72227;-6146;28409;362049;358471;-3000260
1305;13;5;BFC;3444415;41735;0;36080;29947;241026;-11;20535;369312;327577;-3075103
1305;13;5;CVDL;2870185;10445;11036612;201529;36198;49996;0;42829;11377609;330552;8507424
1305;13;5;GE;7238021;511100;13975171;446110;84603;1936507;-179949;63323;16836865;2350594;9598844
1305;13;5;HF;8211442;493442;4944881;464861;24017;1532;0;95794;6024527;586204;-2186915
1305;13;5;IDF;11149587;84374;0;4492;13259;230;0;172333;274688;190314;-10874899
1305;13;5;N;4457126;737560;9044176;136168;20760;14985;0;64009;10017658;235922;5560532
1305;13;5;NlleA;6682801;43839;4722576;82053;166725;1067592;0;186058;6268843;1502428;-413958
1305;13;5;O;5458026;-3571;3494154;426692;213044;3076571;-470013;109081;6845958;3355375;1387932
1305;13;5;PACA;6141604;541530;0;20004;178668;3071537;-110;54922;3866551;3325021;-2275053
1305;13;5;PDL;4060453;396820;0;132277;67785;2190;0;50193;649265;252445;-3411188
1306;13;6;AURA;9229492;71983;12567043;128961;120045;6484027;-614586;87210;18844683;6205657;9615191
1306;13;6;B;2925710;2064;0;201566;35917;83516;-8758;27281;341586;339522;-2584124
1306;13;6;BFC;3049060;40440;0;36671;38436;161244;0;12260;289051;248611;-2760009
1306;13;6;CVDL;2409005;10264;9432563;203677;39535;21641;0;39606;9747286;304459;7338281
1306;13;6;GE;6600991;423138;11622738;500716;111274;1861225;-198681;65103;14385513;2339637;7784522
1306;13;6;HF;7386389;443014;5254773;486855;26789;1453;0;88922;6301806;604019;-1084583
1306;13;6;IDF;9986972;185205;0;4535;14639;6080;0;166779;377238;192033;-9609734
1306;13;6;N;3964106;404202;9634723;132467;22853;15674;0;50093;10260012;221087;6295906
1306;13;6;NlleA;5815162;42031;5633931;74668;180602;911188;0;189403;7031823;1355861;1216661
1306;13;6;O;4811170;23619;3016240;397606;229925;2368525;-409240;104549;5731224;2691365;920054
1306;13;6;PACA;5857865;328344;0;21577;199010;2698943;-474;46868;3294268;2965924;-2563597
1306;13;6;PDL;3619391;328920;0;117546;71508;1086;0;47737;566797;237877;-3052594
1307;13;7;AURA;9702577;58052;12076433;70882;137878;5840128;-492150;84125;17775348;5640863;8072771
1307;13;7;B;3028803;1953;0;174094;44466;68430;-5867;39269;322345;320392;-2706458
1307;13;7;BFC;3120712;38938;0;34211;46206;89078;0;12102;220535;181597;-2900177
1307;13;7;CVDL;2654098;8967;10605637;192782;50129;5707;0;43037;10906259;291655;8252161
1307;13;7;GE;6753599;930919;12803829;450398;128758;1832640;-228023;62617;15981138;2246390;9227539
1307;13;7;HF;7487679;560272;6230655;339523;33158;1473;0;103457;7268538;477611;-219141
1307;13;7;IDF;10025514;164970;0;4137;18479;13046;0;214285;414917;249947;-9610597
1307;13;7;N;4052105;756722;11154426;93060;27390;20937;0;62259;12114794;203646;8062689
1307;13;7;NlleA;6452060;41924;5393866;91393;237050;557336;0;189247;6510816;1075026;58756
1307;13;7;O;5503872;-3260;3062804;151554;267215;2140252;-379073;105492;5344984;2285440;-158888
1307;13;7;PACA;6462303;311619;0;8558;201823;2165025;-603;92115;2778537;2466918;-3683766
1307;13;7;PDL;3848657;335091;0;128546;86485;61;0;50720;600903;265812;-3247754
1308;13;8;AURA;8581173;60972;12948038;93048;127855;4201648;-573714;94152;16951999;3942989;8370826
1308;13;8;B;2865873;1159;0;119745;41043;79030;-8589;44796;277184;276025;-2588689
1308;13;8;BFC;2661854;52413;0;21922;42644;67653;0;17668;202300;149887;-2459554
1308;13;8;CVDL;2386577;8937;8513375;131234;46522;4300;0;47624;8751992;229680;6365415
1308;13;8;GE;5989952;992057;12424184;281116;113980;1375542;-158940;65326;15093265;1677024;9103313
1308;13;8;HF;6721082;608557;5305843;286848;27702;466;0;102581;6331997;417597;-389085
1308;13;8;IDF;8874986;183089;0;2760;15676;10057;0;189480;401062;217973;-8473924
1308;13;8;N;3751453;677979;12525968;82162;24937;20877;0;67437;13399360;195413;9647907
1308;13;8;NlleA;6105467;38937;6506484;60506;213842;190467;0;196678;7206914;661493;1101447
1308;13;8;O;5172657;-2520;1531593;275139;230577;1550070;-479420;106141;3211580;1682507;-1961077
1308;13;8;PACA;6177994;574565;0;14107;199512;1535922;-11375;94033;2406764;1832199;-3771230
1308;13;8;PDL;3476252;810471;0;91490;83955;0;0;47104;1033020;222549;-2443232
1309;13;9;AURA;9145175;87522;12464761;99100;95853;3603969;-529634;90519;15912090;3359807;6766915
1309;13;9;B;2935126;1464;0;134400;28872;75675;-7161;34581;267831;266367;-2667295
1309;13;9;BFC;3035626;103747;0;34033;30233;224945;-7;20850;413801;310054;-2621825
1309;13;9;CVDL;2469358;8693;8396159;180842;30642;1195;0;38665;8656196;251344;6186838
1309;13;9;GE;6780218;1732691;11592858;465040;82541;1332867;-129741;58281;15134537;1808988;8354319
1309;13;9;HF;7481820;518349;5105197;333497;20602;440;0;97331;6075416;451870;-1406404
1309;13;9;IDF;9952434;409520;0;4036;10435;9410;0;144340;577741;168221;-9374693
1309;13;9;N;4006065;748082;11429037;100199;16876;20760;0;59191;12374145;197026;8368080
1309;13;9;NlleA;5933907;42423;7429855;80119;157292;215223;0;180952;8105864;633586;2171957
1309;13;9;O;4923369;-3268;3042165;319571;195595;1212335;-392798;98225;4471825;1432928;-451544
1309;13;9;PACA;5768192;831059;0;14595;167312;1498992;-8599;95203;2598562;1767503;-3169630
1309;13;9;PDL;3619397;1065879;0;113592;58534;0;0;39352;1277357;211478;-2342040
1310;13;10;AURA;10115207;82359;12688331;160520;60004;4611405;-610283;78361;17070697;4300007;6955490
1310;13;10;B;3297035;8097;0;271419;20264;78898;-8365;36693;407006;398909;-2890029
1310;13;10;BFC;3462394;60650;0;61714;19944;152054;-48;17881;312195;251545;-3150199
1310;13;10;CVDL;2839080;15804;8996513;270741;20375;9314;0;49999;9362746;350429;6523666
1310;13;10;GE;7721340;2233509;10605180;768354;51196;1456161;-155788;75934;15034546;2195857;7313206
1310;13;10;HF;8487221;716865;6147541;751513;12333;1100;0;95327;7724679;860273;-762542
1310;13;10;IDF;11406106;404293;0;6782;6912;7135;0;188328;613450;209157;-10792656
1310;13;10;N;4590402;863176;11913221;215080;10759;19266;0;62189;13083691;307294;8493289
1310;13;10;NlleA;6408742;90722;8260005;128828;119329;404443;0;160546;9163873;813146;2755131
1310;13;10;O;5179414;5158;3473239;368464;146991;1383350;-426505;107045;5057742;1579345;-121672
1310;13;10;PACA;6072433;877132;0;16885;111364;1523488;-13394;74710;2590185;1713053;-3482248
1310;13;10;PDL;4052265;1172718;0;175888;38348;64;0;46792;1433810;261092;-2618455
1311;13;11;AURA;12301003;307677;14160915;152784;33340;5796365;-672814;113830;19892097;5423505;7591094
1311;13;11;B;4089256;103218;0;282632;10251;76356;-7150;36126;501433;398215;-3587823
1311;13;11;BFC;4092283;252209;0;78416;9879;163751;-13;21440;525682;273473;-3566601
1311;13;11;CVDL;3693293;107154;11576484;383522;11422;37829;0;50396;12166807;483169;8473514
1311;13;11;GE;8715561;2755421;14759613;875129;24535;1544974;-198984;92567;19853255;2338221;11137694
1311;13;11;HF;9591397;1425882;6453148;670203;5403;1438;0;121142;8677216;798186;-914181
1311;13;11;IDF;14152841;920443;0;8404;3288;39;0;174079;1106253;185810;-13046588
1311;13;11;N;5518722;1115660;12754329;210297;5836;13501;0;75507;14175130;305141;8656408
1311;13;11;NlleA;8230855;156062;6849082;184646;59569;1065787;0;196894;8512040;1506896;281185
1311;13;11;O;7008850;78508;2645892;490310;84608;2223312;-381483;114985;5256132;2531732;-1752718
1311;13;11;PACA;7573302;1138244;0;25972;77850;1646343;-12964;64673;2940118;1801874;-4633184
1311;13;11;PDL;5126101;1404642;0;235073;23513;2876;0;49411;1715515;310873;-3410586
1312;13;12;AURA;13600860;327427;18786308;156993;44034;5032591;-820842;117710;23644221;4530486;10043361
1312;13;12;B;4647978;113937;0;337273;9952;96884;-9324;37954;586676;472739;-4061302
1312;13;12;BFC;4459180;157319;0;73502;13209;160923;0;22348;427301;269982;-4031879
1312;13;12;CVDL;4200814;114292;13997597;405053;14438;23905;0;53830;14609115;497226;10408301
1312;13;12;GE;9195249;2736634;15162622;991495;26629;1311974;-211151;93431;20111634;2212378;10916385
1312;13;12;HF;10205480;1408965;8045589;923429;6900;1946;0;123938;10510767;1056213;305287
1312;13;12;IDF;15381275;887848;0;9535;3737;4155;0;200267;1105542;217694;-14275733
1312;13;12;N;5860348;1044885;14772925;269483;5922;21247;0;66090;16180552;362742;10320204
1312;13;12;NlleA;9377774;166896;6342339;202296;84495;709989;0;181403;7687418;1178183;-1690356
1312;13;12;O;8187511;97608;3687067;376556;104060;2177702;-401243;112807;6154557;2369882;-2032954
1312;13;12;PACA;8693272;752919;0;19937;76487;1685609;-12499;77200;2599653;1846734;-6093619
1312;13;12;PDL;5776630;1246856;0;255889;23883;2113;0;55567;1584308;337452;-4192322
1401;14;1;AURA;13284005;278833;19145877;149937;37036;6212749;-905392;159711;25078751;5654041;11794746
1401;14;1;B;4789670;125115;0;400319;10076;115792;-9373;46089;688018;562903;-4101652
1401;14;1;BFC;4318017;180216;0;76799;11002;266880;-10;27410;562297;382081;-3755720
1401;14;1;CVDL;4056152;109579;16021794;428428;11028;46007;0;75195;16692031;560658;12635879
1401;14;1;GE;9176952;1473126;16129282;1070816;26283;1420758;-208840;123053;20034478;2432070;10857526
1401;14;1;HF;10444971;994197;8007157;1049806;5843;2968;0;142358;10202329;1200975;-242642
1401;14;1;IDF;15258335;671478;0;10895;3097;3641;0;230228;919339;247861;-14338996
1401;14;1;N;5732396;799561;14697103;313095;5752;32035;0;91564;15939110;442446;10206714
1401;14;1;NlleA;9002626;155772;7739711;197796;62129;1040391;0;182993;9378792;1483309;376166
1401;14;1;O;7640007;93260;3581356;379179;80661;2753701;-427843;127938;6588252;2913636;-1051755
1401;14;1;PACA;8641517;573479;0;16460;69075;1975801;-11714;99832;2722933;2149454;-5918584
1401;14;1;PDL;5749177;752033;0;288184;19178;5367;0;60527;1125289;373256;-4623888
1402;14;2;AURA;11942791;249198;16208112;160443;53337;5811853;-742387;151459;21892015;5434705;9949224
1402;14;2;B;4329333;108655;0;437819;16469;98144;-7875;41790;695002;586347;-3634331
1402;14;2;BFC;3882096;132564;0;101986;16289;166434;-23;25569;442819;310255;-3439277
1402;14;2;CVDL;3653607;102905;13898036;544385;19446;56944;0;65986;14687702;686761;11034095
1402;14;2;GE;8317101;1584569;14716662;1219855;36723;1250711;-215065;113828;18707283;2406052;10390182
1402;14;2;HF;9343859;851514;6686554;1124912;10314;2684;0;127798;8803776;1265708;-540083
1402;14;2;IDF;13530928;378125;0;13026;5868;1457;0;222673;621149;243024;-12909779
1402;14;2;N;5192682;804745;10337523;332869;11160;30349;0;90253;11606899;464631;6414217
1402;14;2;NlleA;8366058;175530;7616884;257008;96312;1189986;0;186797;9522517;1730103;1156459
1402;14;2;O;6908445;86033;3276999;396010;124001;3316062;-396469;114483;6917119;3554087;8674
1402;14;2;PACA;7851725;422583;0;16535;88200;2026330;-4158;79323;2628813;2206230;-5222912
1402;14;2;PDL;5237574;280836;0;359581;34425;3973;0;55047;733862;453026;-4503712
1403;14;3;AURA;11869099;279807;15419848;141060;119070;5546448;-721850;163052;20947435;5247780;9078336
1403;14;3;B;4178341;122013;0;220648;30526;113635;-7441;50730;530111;408098;-3648230
1403;14;3;BFC;3784193;150604;0;50193;38082;160908;-17;31353;431123;280519;-3353070
1403;14;3;CVDL;3484823;97657;14314071;228533;40559;40400;0;76142;14797362;385634;11312539
1403;14;3;GE;8163374;1279899;14105128;534925;94706;1216559;-202761;125663;17154119;1769092;8990745
1403;14;3;HF;9218837;865599;6283767;518963;23814;2976;0;138241;7833360;683994;-1385477
1403;14;3;IDF;13055949;561384;0;5741;13134;8300;0;236378;824937;263553;-12231012
1403;14;3;N;5080480;806530;9282786;150222;20316;32312;0;90674;10382840;293524;5302360
1403;14;3;NlleA;7999830;184493;8578068;115202;186625;1101391;0;173929;10339708;1577147;2339878
1403;14;3;O;6608751;99100;3656139;442527;233119;3403098;-375221;134970;7593732;3838493;984981
1403;14;3;PACA;7411451;374016;0;17135;183360;2249293;-8500;97435;2912739;2538723;-4498712
1403;14;3;PDL;4991281;1028910;0;163380;66245;5882;0;57824;1322241;293331;-3669040
1404;14;4;AURA;10193933;50908;13297113;115436;130186;4560384;-600326;98826;17652527;4304506;7458594
1404;14;4;B;3487875;2269;0;206139;35472;77109;-4556;39253;355686;353417;-3132189
1404;14;4;BFC;3240256;39426;0;38407;41161;63242;-62;19440;201614;162188;-3038642
1404;14;4;CVDL;2958170;1067;12792414;181620;40840;13394;0;59303;13088638;295157;10130468
1404;14;4;GE;7019978;981848;10317023;412472;99901;1106903;-202145;79680;12795682;1496811;5775704
1404;14;4;HF;8037732;428963;3937297;372513;26731;2780;0;104337;4872621;506361;-3165111
1404;14;4;IDF;10804521;156391;0;4035;13804;13732;0;214561;402523;246132;-10401998
1404;14;4;N;4332781;363372;10891014;107016;22570;30803;0;55154;11469929;215543;7137148
1404;14;4;NlleA;6466002;49067;8013555;117233;214711;750725;0;185540;9330831;1268209;2864829
1404;14;4;O;5312824;3968;3120412;378974;251451;2577215;-190355;97020;6238685;3114305;925861
1404;14;4;PACA;6150248;217434;0;19322;197924;2348528;-12539;94598;2865267;2647833;-3284981
1404;14;4;PDL;4191470;698922;0;156228;73948;4815;0;49354;983267;284345;-3208203
1405;14;5;AURA;9630215;43924;13338423;179511;146198;5035357;-762073;116366;18097706;4715359;8467491
1405;14;5;B;3130734;3309;0;208031;42767;97603;-9642;44697;386765;383456;-2743969
1405;14;5;BFC;3129698;43253;0;66214;46693;92253;0;24906;273319;230066;-2856379
1405;14;5;CVDL;2687660;1505;12377163;296874;45650;16129;0;64006;12801327;422659;10113667
1405;14;5;GE;6862698;546298;11424479;726486;117781;1628108;-193687;86372;14335837;2365060;7473139
1405;14;5;HF;7900488;355120;4782284;578029;29758;2953;0;129168;5877312;739908;-2023176
1405;14;5;IDF;10568871;95838;0;7005;16632;11598;0;216884;347957;252119;-10220914
1405;14;5;N;4068671;356704;12688077;166402;26233;33944;0;81203;13352563;307782;9283892
1405;14;5;NlleA;6194517;41909;7043050;143325;245696;764053;0;204372;8442405;1357446;2247888
1405;14;5;O;5038153;-6801;1713227;474251;295739;2393902;-476377;118347;4512288;2805862;-525865
1405;14;5;PACA;5920893;292723;0;23498;237603;2203045;-15354;85173;2826688;2533965;-3094205
1405;14;5;PDL;3836433;339622;0;186017;86020;5137;0;56630;673426;333804;-3163007
1406;14;6;AURA;9159952;30533;12601767;110249;172475;4362482;-567598;93839;16803747;4171447;7643795
1406;14;6;B;2851196;2213;0;154192;49258;87571;-9684;39220;322770;320557;-2528426
1406;14;6;BFC;2891138;23240;0;51690;54093;36464;-1;16882;182368;159128;-2708770
1406;14;6;CVDL;2458915;2929;11733017;204970;51360;6991;0;61612;12060879;324933;9601964
1406;14;6;GE;6524128;566204;11959058;497023;138837;1316644;-192123;74800;14360443;1835181;7836315
1406;14;6;HF;7317339;374575;4099209;295084;33200;1667;0;128947;4932682;458898;-2384657
1406;14;6;IDF;9636379;98044;0;4626;18792;7016;0;159530;288008;189964;-9348371
1406;14;6;N;3680729;313246;11940464;82106;31064;22926;0;77384;12467190;213480;8786461
1406;14;6;NlleA;5855691;37652;7958453;104887;289871;549351;0;203432;9143646;1147541;3287955
1406;14;6;O;4955587;-3749;1630444;280758;328333;2057922;-487285;81319;3887742;2261047;-1067845
1406;14;6;PACA;5827038;173250;0;10992;233876;1592470;-15908;68577;2063257;1890007;-3763781
1406;14;6;PDL;3615618;332684;0;123905;98523;2229;0;56568;613909;281225;-3001709
1407;14;7;AURA;9568842;51153;12752769;107582;136632;5739698;-692705;111324;18206453;5402531;8637611
1407;14;7;B;2996911;2971;0;131490;46503;94040;-10267;45694;310431;307460;-2686480
1407;14;7;BFC;2996270;22347;0;41948;40607;168643;0;28096;301641;279294;-2694629
1407;14;7;CVDL;2563116;3015;12301926;168378;46243;9596;0;66577;12595735;290794;10032619
1407;14;7;GE;6672484;238822;15073106;406537;109172;1924458;-232963;79847;17598979;2287051;10926495
1407;14;7;HF;7469821;396123;4768662;341071;28520;1600;0;131193;5667169;502384;-1802652
1407;14;7;IDF;9786914;7631;0;3947;15783;6947;0;207885;242193;234562;-9544721
1407;14;7;N;3798896;319847;13089805;94509;29528;20609;0;73444;13627742;218090;9828846
1407;14;7;NlleA;6236278;37412;6886978;77678;265065;482175;0;192333;7941641;1017251;1705363
1407;14;7;O;5162857;-1347;1854903;406584;298814;1824021;-395212;103348;4091111;2237555;-1071746
1407;14;7;PACA;6344259;190193;0;18342;243060;2069970;-16707;99094;2603952;2413759;-3740307
1407;14;7;PDL;3785736;266733;0;110440;91470;1711;0;60959;531313;264580;-3254423
1408;14;8;AURA;8528835;48487;12704838;76964;152541;4963265;-614247;118950;17450798;4697473;8921963
1408;14;8;B;2869703;933;0;152367;39012;94828;-9669;49449;326920;325987;-2542783
1408;14;8;BFC;2578711;22903;0;42664;43356;146446;-17;26475;281827;258924;-2296884
1408;14;8;CVDL;2326177;1513;10347224;177869;44512;10302;0;66319;10647739;299002;8321562
1408;14;8;GE;5883672;110092;14524595;452186;102111;1963701;-228060;82130;17006755;2372068;11123083
1408;14;8;HF;6773762;474411;5250998;482880;26235;2007;0;133383;6369914;644505;-403848
1408;14;8;IDF;8717103;3454;0;4188;15032;10322;0;190629;223625;220171;-8493478
1408;14;8;N;3582190;331933;12428241;130377;25971;27947;0;82686;13027155;266981;9444965
1408;14;8;NlleA;5773673;36041;4460774;74491;271641;319022;0;195528;5357497;860682;-416176
1408;14;8;O;4982038;-4274;2208861;232841;301116;1485770;-455051;100342;3869605;1665018;-1112433
1408;14;8;PACA;6098187;240609;0;11419;256932;1561472;-6476;100240;2164196;1923587;-3933991
1408;14;8;PDL;3384811;148126;0;109135;81401;3629;0;51514;393805;245679;-2991006
1409;14;9;AURA;9363787;80022;14870694;97242;136716;3136498;-623682;116730;17814220;2863504;8450433
1409;14;9;B;2947630;2117;0;96477;39539;85672;-7326;42043;258522;256405;-2689108
1409;14;9;BFC;2958798;24750;0;39856;43985;132256;0;27432;268279;243529;-2690519
1409;14;9;CVDL;2579490;1501;9478528;146278;44644;5271;0;62902;9739124;259095;7159634
1409;14;9;GE;6662687;730007;15082766;349554;96561;1527514;-197544;68637;17657495;1844722;10994808
1409;14;9;HF;7548244;435893;5082229;239752;23594;1349;0;113521;5896338;378216;-1651906
1409;14;9;IDF;9754849;226014;0;3126;14769;9243;0;165444;418596;192582;-9336253
1409;14;9;N;3794282;331109;10836443;61971;24748;20264;0;93731;11368266;200714;7573984
1409;14;9;NlleA;5913712;30615;5594319;98777;284957;260745;0;194909;6464322;839388;550610
1409;14;9;O;5091339;10665;2866216;209420;267777;1129789;-385216;91886;4190537;1313656;-900802
1409;14;9;PACA;5855935;382616;0;15646;196046;1225215;-149;75591;1894965;1512349;-3960970
1409;14;9;PDL;3607438;592626;0;96120;83957;1689;0;59203;833595;240969;-2773843
1410;14;10;AURA;10109959;151024;14670718;105256;102159;3220388;-728289;131850;17653106;2831364;7543147
1410;14;10;B;3293781;14368;0;234567;23681;92290;-8669;50444;406681;392313;-2887100
1410;14;10;BFC;3340829;27801;0;55403;27794;79972;0;26387;217357;189556;-3123472
1410;14;10;CVDL;2905807;10804;11214695;223394;28146;16969;0;71729;11565737;340238;8659930
1410;14;10;GE;7466547;1543239;14353246;550406;58004;1363907;-225057;96628;17740373;1843888;10273826
1410;14;10;HF;8351425;687523;6065663;638776;14563;1419;0;107259;7515203;762017;-836222
1410;14;10;IDF;11100193;352987;0;5201;8162;11865;0;206974;585189;232202;-10515004
1410;14;10;N;4295132;363770;11919762;190474;14693;22163;0;52764;12563626;280094;8268494
1410;14;10;NlleA;6289668;49375;5694240;122982;224923;353198;0;210604;6655322;911707;365654
1410;14;10;O;5087646;8739;1547143;265659;224267;1215244;-455887;115672;2920837;1364955;-2166809
1410;14;10;PACA;5983356;802831;0;16056;159026;1162239;-96;86220;2226276;1423445;-3757080
1410;14;10;PDL;3975873;590028;0;140074;52660;1889;0;67629;852280;262252;-3123593
1411;14;11;AURA;11230582;416623;14668285;135241;50371;4447831;-798726;171266;19090891;4005983;7860309
1411;14;11;B;3805462;119386;0;250472;12637;104475;-9473;55340;532837;413451;-3272625
1411;14;11;BFC;3618258;165166;0;72787;15504;96606;0;30044;380107;214941;-3238151
1411;14;11;CVDL;3282289;104761;14268477;272380;15096;18000;0;77403;14756117;382879;11473828
1411;14;11;GE;8005145;1372382;16380481;688448;26480;1447959;-181257;117830;19852323;2099460;11847178
1411;14;11;HF;9013561;1035001;6868995;613348;8410;2786;0;152249;8680789;776793;-332772
1411;14;11;IDF;12538478;644154;0;5354;4462;11580;0;204332;869882;225728;-11668596
1411;14;11;N;4868646;522457;11671708;193345;8009;18921;0;85917;12500357;306192;7631711
1411;14;11;NlleA;7179203;162980;7052922;179100;115009;527152;0;221701;8258864;1042962;1079661
1411;14;11;O;5868417;97796;1595528;373772;111858;1369646;-435248;134604;3247956;1554632;-2620461
1411;14;11;PACA;6837190;1129439;0;14896;80034;1683023;-11937;94277;2989732;1860293;-3847458
1411;14;11;PDL;4554643;1010852;0;202311;29212;5661;0;66666;1314702;303850;-3239941
1412;14;12;AURA;13334120;489339;15988977;149889;35574;4517994;-652654;170678;20699797;4221481;7365677
1412;14;12;B;4644527;157761;0;302216;8884;108308;-9114;53399;621454;463693;-4023073
1412;14;12;BFC;4088991;144870;0;110855;6991;101253;-6;30293;394256;249386;-3694735
1412;14;12;CVDL;4218914;116629;16876970;380011;8404;34038;0;75630;17491682;498083;13272768
1412;14;12;GE;9004405;1879061;17431828;1046347;11008;1251091;-219359;121265;21521241;2210352;12516836
1412;14;12;HF;10305642;1115706;7475481;1031555;4219;2940;0;159887;9789788;1198601;-515854
1412;14;12;IDF;15729375;968855;0;8539;2305;8625;0;222363;1210687;241832;-14518688
1412;14;12;N;5856091;564270;14311643;270889;5302;19293;0;101951;15273348;397435;9417257
1412;14;12;NlleA;9191958;183753;8377508;152810;88619;903131;0;226802;9932623;1371362;740665
1412;14;12;O;7876498;100574;2748840;541925;92249;2377633;-379110;139117;5621228;2771814;-2255270
1412;14;12;PACA;8382731;1586749;0;31369;84537;2057401;-5376;100001;3854681;2267932;-4528050
1412;14;12;PDL;5667413;1144471;0;210513;19446;6025;0;68641;1449096;304625;-4218317
1501;15;1;AURA;14189707;501110;19226579;141423;49522;5296378;-648945;146906;24712973;4985284;10523266
1501;15;1;B;4844080;160598;0;367523;11564;115882;-10072;51780;697275;536677;-4146805
1501;15;1;BFC;4696873;186064;0;151166;9912;243860;-4;32881;623879;437815;-4072994
1501;15;1;CVDL;4287930;115972;16886223;448172;12124;42657;0;64746;17569894;567699;13281964
1501;15;1;GE;9532752;2343900;16786079;1159231;18817;1612397;-238729;119210;21800905;2670926;12268153
1501;15;1;HF;10853185;1493482;7777941;1068954;6058;2976;0;166922;10516333;1244910;-336852
1501;15;1;IDF;16392533;997527;0;9873;3057;4016;0;187622;1202095;204568;-15190438
1501;15;1;N;6239804;585796;14993910;301699;6832;21548;0;87063;15996848;417142;9757044
1501;15;1;NlleA;9787497;215870;8200810;195834;109751;756195;0;239374;9717834;1301154;-69663
1501;15;1;O;8549324;91964;3664827;460506;124990;2166060;-392493;125971;6241825;2485034;-2307499
1501;15;1;PACA;9030030;1630943;0;24534;109453;2063116;-12772;97612;3912886;2281943;-5117144
1501;15;1;PDL;6071111;1551228;0;261681;25442;6326;0;65101;1909778;358550;-4161333
1502;15;2;AURA;13330773;647955;16901887;132311;66132;5567209;-482071;130010;22963433;5413591;9632660
1502;15;2;B;4612639;152528;0;324468;19313;107114;-8219;42933;638137;485609;-3974502
1502;15;2;BFC;4358278;203746;0;122928;20246;204726;-11;27992;579627;375881;-3778651
1502;15;2;CVDL;4006217;110084;15336943;395407;20520;47252;0;64823;15975029;528002;11968812
1502;15;2;GE;8809432;2670223;13172454;900123;41873;1153264;-202869;113401;17848469;2005792;9039037
1502;15;2;HF;9865188;1559254;7340087;791016;11305;2691;0;152722;9857075;957734;-8113
1502;15;2;IDF;14884967;1189329;0;8437;6153;4523;0;163906;1372348;183019;-13512619
1502;15;2;N;5785690;529167;12077838;216206;11090;25069;0;80964;12940334;333329;7154644
1502;15;2;NlleA;9011115;206444;6701250;198039;174672;844415;0;222032;8346852;1439158;-664263
1502;15;2;O;7998751;80812;3414906;438673;159592;2693311;-227722;119044;6678616;3182898;-1320135
1502;15;2;PACA;8440288;1638495;0;23570;129118;1922613;-4567;92070;3801299;2162804;-4638989
1502;15;2;PDL;5685747;1594456;0;263444;42606;6368;0;61004;1967878;373422;-3717869
1503;15;3;AURA;12668877;512111;16478397;149984;115192;5449656;-718863;148154;22134631;5144123;9465754
1503;15;3;B;4379340;163749;0;328850;28162;107143;-9603;54235;672536;508787;-3706804
1503;15;3;BFC;4031300;210437;0;108310;35318;187688;-3;33817;575567;365130;-3455733
1503;15;3;CVDL;3680443;114003;16197519;361915;33112;46312;0;71594;16824455;512933;13144012
1503;15;3;GE;8436414;1767195;10481289;941225;89773;1521422;-252772;110107;14658239;2409755;6221825
1503;15;3;HF;9791040;1296796;6973037;934851;20169;3139;0;171607;9399599;1129766;-391441
1503;15;3;IDF;14151153;986041;0;7629;10867;8332;0;174046;1186915;200874;-12964238
1503;15;3;N;5569708;473138;13165555;232701;18474;28254;0;97095;14015217;376524;8445509
1503;15;3;NlleA;8266908;203062;6960672;183647;228731;1055066;0;242829;8874007;1710273;607099
1503;15;3;O;6999075;98295;3629328;506171;228343;2737105;-260547;121408;7060103;3332480;61028
1503;15;3;PACA;7743249;1250304;0;20089;181926;1625152;-1950;104920;3180441;1930137;-4562808
1503;15;3;PDL;5326307;877349;0;244144;63308;7009;0;64408;1256218;378869;-4070089
1504;15;4;AURA;10502724;260275;14543142;132562;163578;4955758;-760196;123605;19418724;4615307;8916000
1504;15;4;B;3370342;4642;0;208094;43587;92726;-9370;51207;390886;386244;-2979456
1504;15;4;BFC;3382965;52561;0;100637;48249;181389;-741;21841;403936;351375;-2979029
1504;15;4;CVDL;2824164;332;12045028;301396;51079;21003;0;63082;12481920;436560;9657756
1504;15;4;GE;7185834;773505;10035775;693775;115537;1704934;-257449;107064;13173141;2363861;5987307
1504;15;4;HF;8271244;666393;4958473;635650;31528;2959;0;138254;6433257;808391;-1837987
1504;15;4;IDF;11101542;100773;0;5904;16439;9858;0;165243;298217;197444;-10803325
1504;15;4;N;4470862;682822;11061842;144557;28410;23617;0;64166;12005414;260750;7534552
1504;15;4;NlleA;6483865;80194;6388812;137188;372380;804460;0;191071;7974105;1505099;1490240
1504;15;4;O;5429936;-5535;3281363;353089;334561;2255761;-34687;99126;6283678;3007850;853742
1504;15;4;PACA;6206083;620104;0;17402;241650;1314153;-894;92327;2284742;1664638;-3921341
1504;15;4;PDL;4132826;130691;0;176579;89649;4935;0;52178;454032;323341;-3678794
1505;15;5;AURA;9613352;68835;13913447;172664;183420;5793415;-770815;130280;19491246;5508964;9877894
1505;15;5;B;3123749;844;0;225576;43131;90608;-9345;56025;406839;405995;-2716910
1505;15;5;BFC;3022204;39293;0;102982;50688;166794;-29;32624;392352;353059;-2629852
1505;15;5;CVDL;2569422;1487;11044828;279603;55750;21842;0;70459;11473969;427654;8904547
1505;15;5;GE;6701932;90010;13409068;692918;117461;1936469;-257540;111627;16100013;2600935;9398081
1505;15;5;HF;7692233;492042;5145006;701030;31194;2976;0;160456;6532704;895656;-1159529
1505;15;5;IDF;10325859;17583;0;5580;17447;6840;0;144400;191850;174267;-10134009
1505;15;5;N;4194588;379910;9647288;170336;28373;19505;0;85713;10331125;303927;6136537
1505;15;5;NlleA;5850052;27579;4157224;135788;388399;794455;0;237205;5740650;1555847;-109402
1505;15;5;O;4949291;-4948;3279926;469778;363893;2346687;-444103;97280;6108513;2833535;1159222
1505;15;5;PACA;5690646;254875;0;22430;279417;1727369;-1;98953;2383043;2128168;-3307603
1505;15;5;PDL;3731524;21195;0;178750;97891;3925;0;50121;351882;330687;-3379642
1506;15;6;AURA;9611862;91285;14392284;88632;202591;5186158;-632528;117625;19446047;4962478;9834185
1506;15;6;B;2897198;4318;0;194516;54475;90718;-10446;49611;383192;378874;-2514006
1506;15;6;BFC;3043359;38753;0;69451;57322;52531;-5588;26319;238788;200035;-2804571
1506;15;6;CVDL;2651087;1489;12650464;233525;65964;5424;0;62233;13019099;367146;10368012
1506;15;6;GE;6564202;110839;12926867;615971;131645;1870418;-227540;90386;15518586;2480880;8954384
1506;15;6;HF;7312902;393055;6076289;631758;38022;1804;0;154893;7295821;826477;-17081
1506;15;6;IDF;9793561;21220;0;4445;21413;12034;0;149085;208197;186977;-9585364
1506;15;6;N;3874988;356616;7882957;146165;35767;20205;0;65025;8506735;267162;4631747
1506;15;6;NlleA;5919890;26778;4043406;92328;470749;384472;0;241117;5258850;1188666;-661040
1506;15;6;O;5061659;-4741;3401661;274605;396066;1837020;-395524;90418;5599505;2202585;537846
1506;15;6;PACA;5764534;316150;0;13195;279283;1758861;0;100311;2467800;2151650;-3296734
1506;15;6;PDL;3607182;14202;0;143879;117275;1382;0;51778;328516;314314;-3278666
1507;15;7;AURA;10145846;234025;14795140;114256;212869;3886623;-460531;140212;18922594;3893429;8776748
1507;15;7;B;2970508;3383;0;179279;45943;83426;-9592;54554;356993;353610;-2613515
1507;15;7;BFC;3110484;37362;0;85780;59006;38177;-3199;30785;247911;210549;-2862573
1507;15;7;CVDL;2683303;1520;11071903;240580;60906;214;0;72017;11447140;373717;8763837
1507;15;7;GE;6598209;704679;16655715;676741;136554;1388538;-225422;91217;19428022;2067628;12829813
1507;15;7;HF;7236411;464410;6404012;695213;31792;1295;0;156512;7753234;884812;516823
1507;15;7;IDF;9822600;25640;0;5245;19610;7086;0;154214;211795;186155;-9610805
1507;15;7;N;3872389;349238;9485185;150626;29812;16098;0;73479;10104438;270015;6232049
1507;15;7;NlleA;6540618;59622;4818176;107716;455428;157484;0;247137;5845563;967765;-695055
1507;15;7;O;5751276;-5080;3256232;378406;393916;1294284;-356377;125292;5086673;1835521;-664603
1507;15;7;PACA;6807529;618981;0;13884;298717;1165444;0;112480;2209506;1590525;-4598023
1507;15;7;PDL;3784548;31578;0;147289;107215;46;0;47345;333473;301895;-3451075
1508;15;8;AURA;8881103;82813;15686416;110681;183304;3179247;-433926;137076;18945611;3176382;10064508
1508;15;8;B;2872064;896;0;166421;40130;97051;-10211;56818;351105;350209;-2520959
1508;15;8;BFC;2714428;35298;0;76165;52261;35334;-8743;31297;221612;186314;-2492816
1508;15;8;CVDL;2387579;1496;11430442;202284;54772;351;0;76275;11765620;333682;9378041
1508;15;8;GE;5976224;81298;15781225;586499;121693;1110988;-218886;90016;17552833;1690310;11576609
1508;15;8;HF;6587879;450046;4832374;464082;29874;532;0;154790;5931698;649278;-656181
1508;15;8;IDF;8886700;6741;0;6631;17481;8070;0;182079;221002;214261;-8665698
1508;15;8;N;3601156;390383;8830144;109530;27752;16561;0;71753;9446123;225596;5844967
1508;15;8;NlleA;5881388;36338;5928166;93951;412084;128538;0;223147;6822224;857720;940836
1508;15;8;O;5081520;-5528;1442968;309831;362950;1076806;-347631;134091;2973487;1536047;-2108033
1508;15;8;PACA;6354862;188571;0;10446;268547;1160151;0;124177;1751892;1563321;-4602970
1508;15;8;PDL;3466368;229220;0;113505;95273;385;0;49602;487985;258765;-2978383
1509;15;9;AURA;9509714;230566;12331182;141924;146798;3031414;-496541;141037;15526380;2964632;6016666
1509;15;9;B;2950005;1493;0;196012;40299;84723;-7973;51409;365963;364470;-2584042
1509;15;9;BFC;3098579;31751;0;127927;43410;98210;-7034;28202;322466;290715;-2776113
1509;15;9;CVDL;2549956;1475;13163181;329893;47232;791;0;72280;13614852;450196;11064896
1509;15;9;GE;6715417;891691;12686834;982669;91901;954656;-174090;96297;15529958;1951433;8814541
1509;15;9;HF;7573366;700771;5178152;692697;23086;1061;0;143542;6739309;860386;-834057
1509;15;9;IDF;9926288;12474;0;13001;14048;11648;0;172387;223558;211084;-9702730
1509;15;9;N;4010905;542848;9251015;161163;25239;17774;0;67118;10065157;271294;6054252
1509;15;9;NlleA;5885458;69092;7026719;154860;355407;316977;0;231821;8154876;1059065;2269418
1509;15;9;O;4865406;2362;1591104;328676;303103;971097;-156713;119261;3158890;1565424;-1706516
1509;15;9;PACA;5875442;586966;0;20147;227476;1378717;-47;103303;2316562;1729596;-3558880
1509;15;9;PDL;3672720;652230;0;191896;88259;77;0;55345;987807;335577;-2684913
1510;15;10;AURA;11124198;361275;13264347;125061;97803;3572969;-599616;124405;16946244;3320622;5822046
1510;15;10;B;3452662;2105;0;221481;24140;91419;-8836;48667;378976;376871;-3073686
1510;15;10;BFC;3636209;42140;0;91020;27715;79745;-6330;22778;257068;214928;-3379141
1510;15;10;CVDL;3015982;5557;11350456;218547;30081;3018;0;72577;11680236;324223;8664254
1510;15;10;GE;7806130;2137744;14681734;599902;54263;959623;-222107;105814;18316973;1497495;10510843
1510;15;10;HF;8655089;1028617;6344344;481731;14799;1288;0;143768;8014547;641586;-640542
1510;15;10;IDF;12100592;49600;0;7570;8447;12191;0;192420;270228;220628;-11830364
1510;15;10;N;4663179;629464;10896927;144497;15656;14964;0;68590;11770098;243707;7106919
1510;15;10;NlleA;6927153;101728;8620276;149808;282732;328550;0;194088;9677182;955178;2750029
1510;15;10;O;5660748;-5306;3668241;343029;226952;1084791;-85656;106162;5338213;1675278;-322535
1510;15;10;PACA;6459846;1758691;0;17534;164605;1591011;0;104042;3635883;1877192;-2823963
1510;15;10;PDL;4337114;1100996;0;176422;58968;16;0;61631;1398033;297037;-2939081
1511;15;11;AURA;11545024;599791;14375377;150221;80122;3108024;-581105;173386;17905816;2930648;6360792
1511;15;11;B;3623598;131480;0;390704;13566;89549;-9583;52789;668505;537025;-2955093
1511;15;11;BFC;3828050;158377;0;179667;18149;74503;-6653;31368;455411;297034;-3372639
1511;15;11;CVDL;3159962;105235;11505818;454483;20005;3767;0;79755;12169063;558010;9009101
1511;15;11;GE;8059384;1982475;16275206;1301933;32879;907148;-195871;120815;20424585;2166904;12365201
1511;15;11;HF;8940383;1400706;6174658;1321629;7491;1811;0;166197;9072492;1497128;132109
1511;15;11;IDF;12524407;710170;0;16512;4922;10758;0;185917;928279;218109;-11596128
1511;15;11;N;4860751;1006174;10665174;336822;9000;12691;0;78744;12108605;437257;7247854
1511;15;11;NlleA;7285988;208051;8962911;177096;193482;274867;0;240416;10056823;885861;2770835
1511;15;11;O;6265057;189131;3323436;483588;177493;1307324;-323858;135369;5292483;1779916;-972574
1511;15;11;PACA;7095899;1802431;0;20334;149895;1301304;0;121853;3395817;1593386;-3700082
1511;15;11;PDL;4503411;835296;0;249711;30856;1329;0;65435;1182627;347331;-3320784
1512;15;12;AURA;12431298;513033;15745493;139367;67403;3374458;-912582;179320;19106492;2847966;6675194
1512;15;12;B;4017544;200735;0;500867;10358;92549;-9743;52824;847590;646855;-3169954
1512;15;12;BFC;4149661;165516;0;174913;17494;115188;-1860;33514;504765;339249;-3644896
1512;15;12;CVDL;3540602;105504;15788535;390931;17460;3444;0;75718;16381592;487553;12840990
1512;15;12;GE;8254839;1611096;17474103;1182368;32638;1020833;-242946;121873;21199965;2114766;12945126
1512;15;12;HF;9196778;1183861;7669815;1517051;6643;2944;0;187604;10567918;1714242;1371140
1512;15;12;IDF;13581887;667251;0;14362;3982;14811;0;201318;901724;234473;-12680163
1512;15;12;N;5191759;1027252;11461681;405655;6818;18014;0;74791;12994211;505278;7802452
1512;15;12;NlleA;8297710;207358;8893529;222630;189795;330397;0;266326;10110035;1009148;1812325
1512;15;12;O;7192183;85409;3467781;290190;135314;1364237;-364262;138510;5117179;1563989;-2075004
1512;15;12;PACA;7976602;1573749;0;7003;82118;957001;0;128455;2748326;1174577;-5228276
1512;15;12;PDL;5058405;750690;0;300154;26742;3403;0;63694;1144683;393993;-3913722
1601;16;1;AURA;13784149;662522;17526702;170000;52916;5201796;-936867;182673;22859742;4670518;9075593
1601;16;1;B;4777785;217679;0;455293;10699;107011;-9662;51889;832909;615230;-3944876
1601;16;1;BFC;4469178;214433;0;208259;12672;194645;-2369;29926;657566;443133;-3811612
1601;16;1;CVDL;4063407;111766;16909169;524372;14137;28167;0;71447;17659058;638123;13595651
1601;16;1;GE;9462779;1757361;17774975;1458951;30531;1405573;-238246;162306;22351451;2819115;12888672
1601;16;1;HF;10405026;1447185;7330270;1491818;11183;3195;0;174979;10458630;1681175;53604
1601;16;1;IDF;15597377;712786;0;18087;3640;15838;0;207271;957622;244836;-14639755
1601;16;1;N;5932299;1070733;10680333;373218;6826;28587;0;69914;12229611;478545;6297312
1601;16;1;NlleA;8995885;250024;9386822;256407;150417;944375;0;261664;11249709;1612863;2253824
1601;16;1;O;7856200;255991;3510165;373840;117563;2131013;-341604;138375;6185343;2419187;-1670857
1601;16;1;PACA;8637388;1416426;0;11967;99741;1145520;0;146311;2819965;1403539;-5817423
1601;16;1;PDL;5761506;1327912;0;347302;26111;5670;0;51154;1758149;430237;-4003357
1602;16;2;AURA;12924143;444578;16419204;180695;66627;6111486;-701809;171871;22692652;5828870;9768509
1602;16;2;B;4466634;213197;0;400735;19317;107428;-6804;47253;781126;567929;-3685508
1602;16;2;BFC;4144143;187236;0;222175;15405;274939;-1023;27905;726637;539401;-3417506
1602;16;2;CVDL;3807218;108677;15605060;551145;23504;53670;0;64619;16406675;692938;12599457
1602;16;2;GE;8754363;1169632;14898334;1610357;39310;1599681;-205766;146680;19258228;3190262;10503865
1602;16;2;HF;9704745;1268721;5728235;1372768;14799;2783;0;156885;8544191;1547235;-1160554
1602;16;2;IDF;14249343;676606;0;18646;6559;3098;0;199349;904258;227652;-13345085
1602;16;2;N;5523450;838203;11272522;320256;12107;28131;0;65774;12536993;426268;7013543
1602;16;2;NlleA;8455545;241339;7412904;251455;233191;1298673;0;222060;9659622;2005379;1204077
1602;16;2;O;7237123;71777;3250186;515347;184317;2617721;-318726;128701;6449323;3127360;-787800
1602;16;2;PACA;7726639;1062579;0;22224;141368;1610087;0;160442;2996700;1934121;-4729939
1602;16;2;PDL;5360024;933455;0;329484;46675;5630;0;50514;1365758;432303;-3994266
1603;16;3;AURA;13262139;545206;15265201;180935;126977;5355206;-600280;183927;21057172;5246765;7795033
1603;16;3;B;4595317;226007;0;380804;32833;108690;-8758;50461;790037;564030;-3805280
1603;16;3;BFC;4233154;186395;0;183051;34760;216249;-2986;32423;649892;463497;-3583262
1603;16;3;CVDL;3820134;101184;15014906;457239;39757;40715;0;62183;15715984;599894;11895850
1603;16;3;GE;8953670;1802567;14676244;1260140;75671;1420948;-186941;149703;19198332;2719521;10244662
1603;16;3;HF;9815186;1321309;7290310;1110029;23318;3753;0;165126;9913845;1302226;98659
1603;16;3;IDF;14517171;639007;0;16598;10456;7384;0;212886;886331;247324;-13630840
1603;16;3;N;5690483;1221147;11220541;251000;19749;29494;0;74365;12816296;374608;7125813
1603;16;3;NlleA;8595312;229532;7341061;246781;386199;1110333;0;274381;9588287;2017694;992975
1603;16;3;O;7347812;82176;3589510;469278;285650;2869495;-295978;119899;7120030;3448344;-227782
1603;16;3;PACA;7774233;1192227;0;23832;217819;1884233;0;168083;3486194;2293967;-4288039
1603;16;3;PDL;5504855;1006686;0;332805;73732;6166;0;53596;1472985;466299;-4031870
1604;16;4;AURA;10821746;160876;13208297;168931;151041;5392076;-611696;157505;18627030;5257857;7805284
1604;16;4;B;3836681;4366;0;234444;40047;96320;-7772;46618;414023;409657;-3422658
1604;16;4;BFC;3468020;39808;0;104541;39624;203936;-175;29818;417552;377744;-3050468
1604;16;4;CVDL;3067312;477;11856958;258735;48138;44345;0;70317;12278970;421535;9211658
1604;16;4;GE;7590707;941255;14329691;762565;95178;1649608;-160417;125884;17743764;2472818;10153057
1604;16;4;HF;8405737;965305;5026734;766036;29887;3786;0;151614;6943362;951323;-1462375
1604;16;4;IDF;11901363;61758;0;9499;15005;10568;0;165259;262089;200331;-11639274
1604;16;4;N;4873366;894289;8324317;178653;26010;27480;0;68348;9519097;300491;4645731
1604;16;4;NlleA;7146849;112539;5944877;120231;431870;981455;0;248415;7839387;1781971;692538
1604;16;4;O;5803429;-1296;3379541;503934;346707;2579825;-35123;107221;6880809;3502564;1077380
1604;16;4;PACA;6175719;1182318;0;25025;252971;1879902;-4;152552;3492764;2310446;-2682955
1604;16;4;PDL;4681532;494310;0;198536;86550;6493;0;51174;837063;342753;-3844469
1605;16;5;AURA;9921434;127932;13300244;193733;180940;5613932;-617352;143222;18942651;5514475;9021217
1605;16;5;B;3124917;1939;0;171184;46797;97235;-9548;54420;362027;360088;-2762890
1605;16;5;BFC;3196219;44178;0;124442;46948;232563;-124;27581;475588;431410;-2720631
1605;16;5;CVDL;2620013;77;11528884;246807;52761;25135;0;76382;11930046;401085;9310033
1605;16;5;GE;6928733;469275;12688203;640444;115125;1978084;-203542;127024;15814613;2657135;8885880
1605;16;5;HF;7594584;707680;4805763;623901;34567;3362;0;161511;6336784;823341;-1257800
1605;16;5;IDF;10545359;45130;0;8416;15272;12711;0;198619;280148;235018;-10265211
1605;16;5;N;4046089;628221;8183595;140379;29932;23210;0;57659;9062996;251180;5016907
1605;16;5;NlleA;6164489;53125;6404052;135646;501991;921586;0;239809;8256209;1799032;2091720
1605;16;5;O;5218243;-2610;1910019;600008;405084;2462465;-425854;120702;5069814;3162405;-148429
1605;16;5;PACA;5835200;668619;0;26426;300534;1679342;-215;157964;2832670;2164051;-3002530
1605;16;5;PDL;3882000;21014;0;166353;98130;5517;0;53170;344184;323170;-3537816
1606;16;6;AURA;9324412;187168;10104003;91419;188391;6501398;-537120;144194;16679453;6388282;7355041
1606;16;6;B;2916409;3614;0;126684;37345;92040;-9337;43288;293634;290020;-2622775
1606;16;6;BFC;2991791;36000;0;73870;46542;265598;-200;28266;450076;414076;-2541715
1606;16;6;CVDL;2408719;6;10768868;173581;48922;35113;0;69204;11095694;326820;8686975
1606;16;6;GE;6520625;718017;11884289;427674;108702;1972095;-179862;101532;15032447;2430141;8511822
1606;16;6;HF;7387191;668345;5605296;506710;28908;2878;0;139988;6952125;678484;-435066
1606;16;6;IDF;9892004;33143;0;5682;14475;44;0;194012;247356;214213;-9644648
1606;16;6;N;3835034;575993;9746336;113465;25214;7304;0;54039;10522351;200022;6687317
1606;16;6;NlleA;5816461;54692;6553227;92430;474851;1069008;0;237360;8481568;1873649;2665107
1606;16;6;O;4959691;-1027;2573306;388986;417380;2190689;-372071;113281;5310544;2738265;350853
1606;16;6;PACA;5642559;666324;0;13657;308134;2209870;0;114585;3312570;2646246;-2329989
1606;16;6;PDL;3605165;23673;0;124512;87316;3825;0;54045;293371;269698;-3311794
1607;16;7;AURA;9602567;226161;10426409;107609;214243;5206445;-466634;152685;15866918;5214348;6264351
1607;16;7;B;2921041;1306;0;129883;49499;98208;-10972;59408;327332;326026;-2593709
1607;16;7;BFC;2995115;41850;0;57154;59628;77533;-104;35017;271078;229228;-2724037
1607;16;7;CVDL;2477809;1;8863593;173811;66328;4146;0;75279;9183158;319564;6705349
1607;16;7;GE;6501631;1023950;12852064;376271;132258;2008184;-208269;109859;16294317;2418303;9792686
1607;16;7;HF;7169451;896407;5033639;486797;36925;2974;0;155114;6611856;681810;-557595
1607;16;7;IDF;9514029;24669;0;5484;19310;11068;0;252959;313490;288821;-9200539
1607;16;7;N;3863865;450793;9239904;108544;33546;18923;0;70678;9922388;231691;6058523
1607;16;7;NlleA;6359077;52902;6818781;83570;575569;292518;0;237746;8061086;1189403;1702009
1607;16;7;O;5511460;400;3401343;372270;461909;1375742;-281670;135647;5465641;2063898;-45819
1607;16;7;PACA;6346179;954361;0;16630;333291;1496449;-1;145741;2946471;1992110;-3399708
1607;16;7;PDL;3696098;20970;0;114197;114342;1282;0;57175;307966;286996;-3388132
1608;16;8;AURA;8838455;171175;9316097;101700;214634;3591743;-530584;160431;13025196;3537924;4186741
1608;16;8;B;2879171;1052;0;177842;50023;97098;-10133;57233;373115;372063;-2506056
1608;16;8;BFC;2850754;35028;0;65159;59032;38779;0;35432;233430;198402;-2617324
1608;16;8;CVDL;2373340;1;9893926;192275;66303;570;0;81753;10234828;340901;7861488
1608;16;8;GE;6054441;1207685;11856109;432720;128740;1701681;-205932;100881;15221884;2158090;9167443
1608;16;8;HF;6686101;1302430;4359318;632041;35271;2381;0;165376;6496817;835069;-189284
1608;16;8;IDF;8898940;16279;0;6794;18287;9753;0;196297;247410;231131;-8651530
1608;16;8;N;3717036;515784;8674926;148980;32304;19365;0;76144;9467503;276793;5750467
1608;16;8;NlleA;6225854;57486;6604602;81866;580544;114137;0;227254;7665889;1003801;1440035
1608;16;8;O;5512264;127;3483304;375855;464963;1037270;-331104;137509;5167924;1684493;-344340
1608;16;8;PACA;6154047;583937;0;15083;322595;1116206;0;150930;2188751;1604814;-3965296
1608;16;8;PDL;3584355;2542;0;140674;115155;188;0;51851;310410;307868;-3273945
1609;16;9;AURA;9392043;333445;9715609;101102;162296;3032259;-631704;140792;12853799;2804745;3461756
1609;16;9;B;2929969;3280;0;151192;35296;88526;-7308;54786;325772;322492;-2604197
1609;16;9;BFC;3074601;38689;0;73245;44811;102358;-50;28160;287213;248524;-2787388
1609;16;9;CVDL;2449213;211;9682553;134045;47254;1606;0;72634;9938303;255539;7489090
1609;16;9;GE;6666790;2372301;13365182;392731;102715;1252475;-204625;105523;17386302;1648819;10719512
1609;16;9;HF;7284037;1775030;4336625;474865;27757;1268;0;159927;6775472;663817;-508565
1609;16;9;IDF;9641433;99549;0;4713;12740;10065;0;201434;328501;228952;-9312932
1609;16;9;N;3851392;918871;6893726;121808;21831;20070;0;71585;8047891;235294;4196499
1609;16;9;NlleA;5939017;48232;5472404;68387;452249;255269;0;200353;6496894;976258;557877
1609;16;9;O;5242264;1691;3458335;348411;372310;853540;-134585;124883;5024585;1564559;-217679
1609;16;9;PACA;5932020;1960659;0;10916;259526;1113139;0;141546;3485786;1525127;-2446234
1609;16;9;PDL;3667644;414737;0;97606;77381;0;0;51575;641299;226562;-3026345
1610;16;10;AURA;10861423;613526;11522409;128911;144036;2848028;-754852;127315;14629373;2493438;3767950
1610;16;10;B;3529614;9711;0;189976;43120;92804;-8596;52565;379580;369869;-3150034
1610;16;10;BFC;3604134;91972;0;131375;42122;65162;-60;22377;352948;260976;-3251186
1610;16;10;CVDL;2980542;7930;12042009;260184;44978;1342;0;75669;12432112;382173;9451570
1610;16;10;GE;7736463;2654792;12172619;712447;78792;950889;-245001;125755;16450293;1622882;8713830
1610;16;10;HF;8458582;1587760;3954743;576155;28520;1478;0;156037;6304693;762190;-2153889
1610;16;10;IDF;11755693;298829;0;8655;14589;9905;0;207393;539371;240542;-11216322
1610;16;10;N;4574159;707477;7116601;141321;24533;19997;0;77396;8087325;263247;3513166
1610;16;10;NlleA;6802272;107776;7405953;128589;411267;200697;0;150003;8404285;890556;1602013
1610;16;10;O;5643021;1271;3707291;325038;306115;970261;-195106;127890;5242760;1534198;-400261
1610;16;10;PACA;6283117;2827153;0;18865;205949;956934;-16;150053;4158938;1331785;-2124179
1610;16;10;PDL;4391296;923574;0;187504;87819;0;0;64321;1263218;339644;-3128078
1611;16;11;AURA;12143024;834412;10128641;168920;66024;3929839;-705351;185915;14608400;3645347;2465376
1611;16;11;B;4193222;188340;0;328750;15789;89992;-8409;51813;666275;477935;-3526947
1611;16;11;BFC;4084832;187207;0;187043;14454;117713;-1400;27494;532511;345304;-3552321
1611;16;11;CVDL;3567247;109000;12792014;443319;19024;13079;0;69177;13445613;544599;9878366
1611;16;11;GE;8663538;2949717;14359385;1146332;33254;1261689;-203311;163205;19710271;2401169;11046733
1611;16;11;HF;9523222;2275500;4145045;1067697;12246;1607;0;158928;7661023;1240478;-1862199
1611;16;11;IDF;13725466;1030798;0;13399;4683;11337;0;213268;1273485;242687;-12451981
1611;16;11;N;5290560;1110908;9999520;277784;9756;18880;0;70867;11487715;377287;6197155
1611;16;11;NlleA;7951817;270763;7286673;227793;219827;321595;0;251586;8578237;1020801;626420
1611;16;11;O;6671073;89449;3536074;471399;161203;1314241;-253512;134413;5453267;1827744;-1217806
1611;16;11;PACA;7208224;2638701;0;18358;128705;1349615;-65;163366;4298680;1659979;-2909544
1611;16;11;PDL;5060989;1370050;0;292047;37576;904;0;63559;1764136;394086;-3296853
1612;16;12;AURA;14217542;934664;12928505;121660;74377;3777488;-621320;191301;17406675;3543506;3189133
1612;16;12;B;4772983;283686;0;212456;12496;95046;-9578;53065;647171;363485;-4125812
1612;16;12;BFC;4664718;212654;0;128801;15680;107225;-7901;28342;484801;272147;-4179917
1612;16;12;CVDL;4185596;122588;16449949;188870;18862;6918;0;75920;16863107;290570;12677511
1612;16;12;GE;9474837;3290156;14473019;657903;32062;827555;-154024;176448;19303119;1539944;9828282
1612;16;12;HF;10291835;2638038;4795362;778127;12588;1486;0;152992;8378593;945193;-1913242
1612;16;12;IDF;15809878;988829;0;5760;4162;14132;0;229726;1242609;253780;-14567269
1612;16;12;N;6013356;1263365;13139987;193195;8971;21140;0;80346;14707004;303652;8693648
1612;16;12;NlleA;9213190;353747;7735414;155458;207684;368393;0;255816;9076512;987351;-136678
1612;16;12;O;7959577;98580;3739829;406605;175423;1786607;-277946;136508;6065606;2227197;-1893971
1612;16;12;PACA;8233688;2844504;0;14118;129257;1851024;-152;179791;5018542;2174038;-3215146
1612;16;12;PDL;5931146;1515525;0;193550;31156;1198;0;67219;1808648;293123;-4122498
1701;17;1;AURA;15983820;827598;16374962;176416;61934;4412065;-598351;172958;21427582;4225022;5443762
1701;17;1;B;5448620;329593;0;250165;15813;96582;-8685;56445;739913;410320;-4708707
1701;17;1;BFC;5212316;256064;0;184296;14473;124197;-4453;32373;606950;350886;-4605366
1701;17;1;CVDL;4751054;169951;17075397;332389;19245;8355;0;75983;17681320;435972;12930266
1701;17;1;GE;10585463;3547260;16878131;981247;32516;725387;-170880;170641;22164302;1738911;11578839
1701;17;1;HF;11392391;2734840;6084899;842738;7706;1807;0;161619;9833609;1013870;-1558782
1701;17;1;IDF;17785746;1639446;0;10270;4035;14666;0;215085;1883502;244056;-15902244
1701;17;1;N;6608577;1292053;12953054;191909;9190;23909;0;72605;14542720;297613;7934143
1701;17;1;NlleA;10753691;396715;7781218;252508;208054;539577;0;294664;9472736;1294803;-1280955
1701;17;1;O;9515290;111502;3808263;610669;175204;2139605;-341409;134195;6638029;2718264;-2877261
1701;17;1;PACA;9428965;2756416;0;30859;128361;2199101;-6694;204519;5312562;2556146;-4116403
1701;17;1;PDL;6697039;2240812;0;224201;36689;2047;0;64999;2568748;327936;-4128291
1702;17;2;AURA;12131749;694089;14520756;202227;88372;3757069;-666887;155632;18751258;3536413;6619509
1702;17;2;B;4292719;273199;0;355685;18553;95769;-8700;52591;787097;513898;-3505622
1702;17;2;BFC;3976549;178822;0;214925;20799;139373;0;30755;584674;405852;-3391875
1702;17;2;CVDL;3554354;139181;15236905;439972;22426;16439;0;66742;15921665;545579;12367311
1702;17;2;GE;8369412;2782870;13960518;1196892;41660;1059321;-164983;143922;19020200;2276812;10650788
1702;17;2;HF;9229717;2439889;4912885;1206296;8417;2686;0;163440;8733613;1380839;-496104
1702;17;2;IDF;13337869;718063;0;14357;5193;15336;0;201655;954604;236541;-12383265
1702;17;2;N;5242113;897741;9544035;298662;9939;25688;0;62483;10838548;396772;5596435
1702;17;2;NlleA;7962515;355671;6185396;272545;237919;526531;0;258707;7836769;1295702;-125746
1702;17;2;O;6861818;97389;2980753;545161;207508;2085418;-427581;123728;5612376;2534234;-1249442
1702;17;2;PACA;7109679;1839263;0;20370;139918;1163663;-9497;148481;3302198;1462935;-3807481
1702;17;2;PDL;5150166;1633695;0;308691;41927;3730;0;61639;2049682;415987;-3100484
1703;17;3;AURA;11917769;587429;15887622;179511;141021;5337493;-737153;174082;21570005;5094954;9652236
1703;17;3;B;4104309;302635;0;344001;31015;108474;-6758;58465;837832;535197;-3266477
1703;17;3;BFC;3863725;158365;0;237262;35828;195325;-4517;34223;656486;498121;-3207239
1703;17;3;CVDL;3460318;141491;16641591;410128;38076;40630;0;78069;17349985;566903;13889667
1703;17;3;GE;8240260;2035415;11065727;1387291;85422;1561372;-132825;138770;16141172;3040030;7900912
1703;17;3;HF;9129423;2127924;5384215;1391627;21072;2849;0;175552;9103239;1591100;-26184
1703;17;3;IDF;12898066;614717;0;19842;10843;9605;0;195345;850352;235635;-12047714
1703;17;3;N;5093379;982723;8896531;302660;18099;26266;0;66321;10292600;413346;5199221
1703;17;3;NlleA;7810422;372921;8288057;237586;359050;973970;0;286543;10518127;1857149;2707705
1703;17;3;O;6540200;94409;2424363;521919;334958;2553092;-449737;137230;5616234;3097462;-923966
1703;17;3;PACA;6946690;1807826;0;16849;236022;1545474;-12631;164207;3757747;1949921;-3188943
1703;17;3;PDL;5053906;822215;0;274462;67125;4427;0;66971;1235200;412985;-3818706
1704;17;4;AURA;10317440;313454;14233907;183000;201534;3383999;-601244;130849;17845499;3298138;7528059
1704;17;4;B;3367050;3358;0;180614;50284;94784;-8794;56680;376926;373568;-2990124
1704;17;4;BFC;3362378;54639;0;131171;56883;75251;-9683;34205;342466;287827;-3019912
1704;17;4;CVDL;2939361;334;15594231;218099;66184;9264;0;75255;15963367;368802;13024006
1704;17;4;GE;7187228;1545935;10336161;571715;117750;1121015;-120452;122305;13694429;1812333;6507201
1704;17;4;HF;8040400;1536481;4348003;567435;31289;2853;0;160186;6646247;761763;-1394153
1704;17;4;IDF;10943744;7108;0;9480;17775;13767;0;202952;251082;243974;-10692662
1704;17;4;N;4444385;791897;8366745;109521;31785;23302;0;70256;9393506;234864;4949121
1704;17;4;NlleA;6603142;124799;8045950;225354;590822;565478;0;274827;9827230;1656481;3224088
1704;17;4;O;5431402;3495;2542282;522769;473294;1916040;-413400;118424;5162904;2617127;-268498
1704;17;4;PACA;6015569;1177181;0;27190;303783;1050608;-11125;176735;2724372;1547191;-3291197
1704;17;4;PDL;4205087;1074640;0;194046;115652;1947;0;64475;1450760;376120;-2754327
1705;17;5;AURA;9984024;252408;11542914;149332;211851;4884891;-725275;124957;16441078;4645756;6457054
1705;17;5;B;3114583;7735;0;218069;52459;103128;-11028;61786;432149;424414;-2682434
1705;17;5;BFC;3264527;60699;0;149754;59926;98877;-12637;27816;384435;323736;-2880092
1705;17;5;CVDL;2632674;3;12839861;241683;66319;12543;0;85546;13245955;406091;10613281
1705;17;5;GE;6932825;1462728;12416839;603357;134724;1639035;-126838;130931;16260776;2381209;9327951
1705;17;5;HF;7747705;1076315;5121511;653745;34247;1715;0;164812;7052345;854519;-695360
1705;17;5;IDF;10423078;13579;0;10351;20364;9731;0;196313;250338;236759;-10172740
1705;17;5;N;4133696;446572;7111403;150804;33082;22555;0;71983;7836399;278424;3702703
1705;17;5;NlleA;6165314;77969;7567227;198017;591984;573872;0;257860;9266929;1621733;3101615
1705;17;5;O;5300285;3021;3626822;414844;487289;2028623;-430883;127128;6256844;2627001;956559
1705;17;5;PACA;6010257;405417;0;12760;331477;2016919;-13388;175661;2928846;2523429;-3081411
1705;17;5;PDL;3946326;773183;0;202299;120614;1850;0;58209;1156155;382972;-2790171
1706;17;6;AURA;9524426;52888;10745714;113826;225037;4877049;-608684;130052;15535882;4737280;6011456
1706;17;6;B;2870377;24174;0;172254;57418;89123;-10483;61987;394473;370299;-2475904
1706;17;6;BFC;3022510;47039;0;141255;65591;58502;-10971;32619;334035;286996;-2688475
1706;17;6;CVDL;2558030;28;10010305;213888;73989;7209;0;85262;10390681;380348;7832651
1706;17;6;GE;6607974;1108633;13299928;685350;146061;1512823;-152345;104628;16705078;2296517;10097104
1706;17;6;HF;7246385;1035917;4558549;791271;38917;1107;0;154664;6580425;985959;-665960
1706;17;6;IDF;9650336;37506;0;10087;22240;6495;0;216661;292989;255483;-9357347
1706;17;6;N;3771754;559744;6477317;149379;37530;15174;0;61173;7300317;263256;3528563
1706;17;6;NlleA;5996649;64040;5141450;156997;591036;353514;0;268832;6575869;1370379;579220
1706;17;6;O;5311615;4781;3495037;342303;486756;1442092;-313084;101938;5559823;2060005;248208
1706;17;6;PACA;6049351;628912;0;11180;349224;1788688;-17874;228497;2988627;2359715;-3060724
1706;17;6;PDL;3703009;297157;0;161044;131561;42;0;64845;654649;357492;-3048360
1707;17;7;AURA;9716990;44322;13173465;138684;216710;3708368;-416265;165207;17030491;3812704;7313501
1707;17;7;B;2956193;3373;0;215655;50737;94949;-11748;68610;421576;418203;-2534617
1707;17;7;BFC;3070508;48012;0;145081;57512;44280;-8531;32271;318625;270613;-2751883
1707;17;7;CVDL;2577716;51;9292276;285093;62065;1149;0;92705;9733339;441012;7155623
1707;17;7;GE;6635536;1498379;14966210;741766;127874;1361322;-147147;114018;18662422;2197833;12026886
1707;17;7;HF;7182615;1667425;3508031;816673;33681;395;0;171143;6197348;1021892;-985267
1707;17;7;IDF;9387568;8248;0;13268;18933;7083;0;260324;307856;299608;-9079712
1707;17;7;N;3851586;876030;7652729;170774;32478;14242;0;69775;8816028;287269;4964442
1707;17;7;NlleA;6247952;59937;5904924;151345;540519;321755;0;258380;7236860;1271999;988908
1707;17;7;O;5466289;86;1784530;529545;482811;1024782;-392146;121956;3551564;1766948;-1914725
1707;17;7;PACA;6411840;1210443;0;18007;385192;1176003;-9135;213279;2993789;1783346;-3418051
1707;17;7;PDL;3753459;815045;0;200667;112409;3;0;67802;1195926;380881;-2557533
1708;17;8;AURA;9002494;95566;14345408;110466;210449;3263179;-495060;144738;17674746;3233772;8672252
1708;17;8;B;2913617;2173;0;174596;48856;94047;-10611;68121;377182;375009;-2536435
1708;17;8;BFC;2745741;41010;0;103416;55941;43297;-9856;31547;265355;224345;-2480386
1708;17;8;CVDL;2404306;10;10446593;199730;62502;643;0;92198;10801676;355073;8397370
1708;17;8;GE;6009783;882789;11330364;511894;118762;1430339;-169171;119146;14224123;2010970;8214340
1708;17;8;HF;6741540;1184585;5582863;569094;30065;436;0;173529;7540572;773124;799032
1708;17;8;IDF;8685113;5941;0;10804;17537;6849;0;207382;248513;242572;-8436600
1708;17;8;N;3652571;592949;7752899;125366;30170;14273;0;77040;8592697;246849;4940126
1708;17;8;NlleA;6127133;65766;5811025;114290;577778;151225;0;269988;6990072;1113281;862939
1708;17;8;O;5510916;951;1864452;400602;459210;965836;-331008;133915;3493958;1628555;-2016958
1708;17;8;PACA;6366527;711546;0;13879;336922;1005146;-8180;193634;2252947;1541401;-4113580
1708;17;8;PDL;3542150;151173;0;149194;113818;0;0;60405;474590;323417;-3067560
1709;17;9;AURA;9522056;182389;16492470;109933;157246;2566553;-596622;133413;19045382;2370523;9523326
1709;17;9;B;3059863;3764;0;241670;34489;92086;-10095;58791;420705;416941;-2639158
1709;17;9;BFC;3085146;40549;0;143735;42230;119225;-7280;33569;372028;331479;-2713118
1709;17;9;CVDL;2469947;19;8812767;255721;48350;5974;0;88612;9211443;398657;6741496
1709;17;9;GE;6822489;1449480;10815538;767750;92399;1483698;-168534;124572;14564903;2299885;7742414
1709;17;9;HF;7546450;1223769;6201504;791694;23582;1064;0;164771;8406384;981111;859934
1709;17;9;IDF;9804539;14843;0;16025;13692;7263;0;231255;283078;268235;-9521461
1709;17;9;N;3938334;864761;7227913;188709;22598;18209;0;71772;8393962;301288;4455628
1709;17;9;NlleA;6000718;62568;7060170;146007;441018;254848;0;254297;8218908;1096170;2218190
1709;17;9;O;5116201;376;2047492;437884;365602;735528;-191759;118700;3513823;1465955;-1602378
1709;17;9;PACA;5753125;1272346;0;13518;283907;869964;-10187;192821;2622369;1350023;-3130756
1709;17;9;PDL;3734132;652631;0;186579;86378;356;0;59217;985161;332530;-2748971
1710;17;10;AURA;10265675;516688;11151880;172616;143783;2262024;-802277;156818;13601532;1932964;3335857
1710;17;10;B;3376099;5460;0;230341;25666;90877;-8977;53333;396700;391240;-2979399
1710;17;10;BFC;3484192;88898;0;180959;35619;85907;-1687;25973;415669;326771;-3068523
1710;17;10;CVDL;2785258;5708;8947186;278894;41511;550;0;95063;9368912;416018;6583654
1710;17;10;GE;7571803;2769114;10988847;961022;69249;1203331;-150690;138515;15979388;2221427;8407585
1710;17;10;HF;8192856;1962477;4843343;1186472;16941;1523;0;138709;8149465;1343645;-43391
1710;17;10;IDF;10902493;92265;0;17010;10295;8640;0;211790;340000;247735;-10562493
1710;17;10;N;4341100;920459;7092828;247424;17157;19804;0;77144;8374816;361529;4033716
1710;17;10;NlleA;6457322;124388;9269511;154410;385590;223054;0;275919;10432872;1038973;3975550
1710;17;10;O;5395377;1691;3715558;545222;325103;793428;-385140;125507;5121369;1404120;-274008
1710;17;10;PACA;5872796;2311451;0;18653;264841;745831;-14303;170165;3496638;1185187;-2376158
1710;17;10;PDL;4081491;1661932;0;181855;65295;222;0;65617;1974921;312989;-2106570
1711;17;11;AURA;12617885;705503;8552148;222556;76034;3488767;-693951;189259;12540316;3282665;-77569
1711;17;11;B;4208904;225506;0;274628;17867;91308;-9341;58223;658191;432685;-3550713
1711;17;11;BFC;4171403;207379;0;250918;16525;102745;-73;34708;612202;404823;-3559201
1711;17;11;CVDL;3609892;130947;10912199;363680;21595;1535;0;80785;11510741;467595;7900849
1711;17;11;GE;8636591;2721116;12507796;1076382;28822;1342041;-167802;175122;17683477;2454565;9046886
1711;17;11;HF;9491871;2570254;5629681;1042762;9977;2211;0;183638;9438523;1238588;-53348
1711;17;11;IDF;13477374;889125;0;21503;5294;8259;0;222339;1146520;257395;-12330854
1711;17;11;N;5197968;1194726;9874658;260898;9945;21219;0;81884;11443330;373946;6245362
1711;17;11;NlleA;8342405;292847;9512288;214462;268772;380391;0;266784;10935544;1130409;2593139
1711;17;11;O;7218815;94283;3653641;675333;215360;1329250;-339653;136229;5764443;2016519;-1454372
1711;17;11;PACA;7334460;2917546;0;26720;176859;1072815;-6562;242111;4429489;1511943;-2904971
1711;17;11;PDL;5094622;1914685;0;238766;43457;1370;0;66163;2264441;349756;-2830181
1712;17;12;AURA;14409308;633367;12870790;257856;42260;4706409;-755517;199220;17954385;4450228;3545077
1712;17;12;B;4866491;342126;0;433519;10581;107666;-10416;66221;949697;607571;-3916794
1712;17;12;BFC;4618364;252834;0;319968;9107;209063;-5406;37395;822961;570127;-3795403
1712;17;12;CVDL;4179225;142141;13823835;538896;11621;29467;0;84156;14630116;664140;10450891
1712;17;12;GE;9279351;2598249;15103045;1650035;16784;1561494;-171493;182083;20940197;3238903;11660846
1712;17;12;HF;10656322;2456980;6676810;1686948;5084;2922;0;196185;11024929;1891139;368607
1712;17;12;IDF;15348100;839432;0;30251;2760;9640;0;226440;1108523;269091;-14239577
1712;17;12;N;5931134;680471;12991690;393746;5686;28035;0;78815;14178443;506282;8247309
1712;17;12;NlleA;9658661;303680;9698495;338869;151610;834268;0;244756;11571678;1569503;1913017
1712;17;12;O;8925690;122473;3575345;709554;139669;1794841;-438563;137490;6040809;2342991;-2884881
1712;17;12;PACA;9161820;2139501;0;24726;119777;1235221;-9847;164593;3673971;1534470;-5487849
1712;17;12;PDL;5848190;1464148;0;377183;25882;4776;0;66339;1938328;474180;-3909862
1801;18;1;AURA;13476522;372930;17015554;279545;43958;5950903;-913520;197159;22946529;5558045;9470007
1801;18;1;B;4745546;341724;0;540600;8164;125163;-10562;62027;1067116;725392;-3678430
1801;18;1;BFC;4321365;241565;0;399531;8837;352299;-680;41372;1042924;801359;-3278441
1801;18;1;CVDL;3927224;176924;14693183;614259;10813;83309;0;88708;15667196;797089;11739972
1801;18;1;GE;8969955;927918;15917080;1990349;48533;1739693;-207280;139430;20555723;3710725;11585768
1801;18;1;HF;10950713;1402915;7852994;1986942;3521;2420;0;177816;11426608;2170699;475895
1801;18;1;IDF;14123224;561609;0;37456;1868;525;0;217271;818729;257120;-13304495
1801;18;1;N;5801059;757376;13074741;454438;4218;23702;0;73625;14388100;555983;8587041
1801;18;1;NlleA;8988188;341518;9515901;453041;141294;1529727;0;261553;12243034;2385615;3254846
1801;18;1;O;7919996;123435;3453952;759748;133812;3165720;-457862;135343;7314148;3736761;-605848
1801;18;1;PACA;8023656;1011100;0;21920;130988;1483376;-16808;148463;2779039;1767939;-5244617
1801;18;1;PDL;5625209;738736;0;470906;18372;4146;0;67190;1299350;560614;-4325859
1802;18;2;AURA;13763653;590079;14231223;174725;81398;5791529;-508905;179252;20539301;5717999;6775648
1802;18;2;B;4844702;342101;0;369758;27613;92818;-6559;57752;883483;541382;-3961219
1802;18;2;BFC;4450407;225014;0;227677;23126;275212;-1932;36217;785314;560300;-3665093
1802;18;2;CVDL;4192622;150589;13694604;406522;26928;54310;0;77202;14410155;564962;10217533
1802;18;2;GE;9148043;2335837;14444637;1226480;116034;1397629;-124751;129121;19524987;2744513;10376944
1802;18;2;HF;10084985;2266776;7064243;1506982;17063;2550;0;165308;11022922;1691903;937937
1802;18;2;IDF;15383969;693973;0;23892;7560;0;0;198281;923706;229733;-14460263
1802;18;2;N;5898935;1187322;11279330;319670;16229;20017;0;69467;12892035;425383;6993100
1802;18;2;NlleA;9449128;283690;8675415;352951;294587;1192676;0;229818;11029137;2070032;1580009
1802;18;2;O;8306402;113608;3416138;586296;221528;3313158;-330815;121646;7441559;3911813;-864843
1802;18;2;PACA;8371895;2206819;0;24661;178194;2070604;-4006;233183;4709455;2502636;-3662440
1802;18;2;PDL;5921151;1539466;0;340119;58870;5549;0;63185;2007189;467723;-3913962
1803;18;3;AURA;13457497;414378;14526164;244544;144262;5626890;-708225;185897;20433910;5493368;6976413
1803;18;3;B;4825375;367806;0;425379;29635;86623;-5045;63535;967933;600127;-3857442
1803;18;3;BFC;4367041;238017;0;287132;35811;240753;-5709;41283;837287;599270;-3529754
1803;18;3;CVDL;3867523;151569;14371747;490055;41252;43366;0;77463;15175452;652136;11307929
1803;18;3;GE;9161162;2028414;14257131;1350955;145260;1387179;-166333;149485;19152091;2866546;9990929
1803;18;3;HF;9914277;1810464;6686881;1527182;15813;3343;0;176428;10220111;1722766;305834
1803;18;3;IDF;14890436;753204;0;26936;10336;4;0;214950;1005430;252226;-13885006
1803;18;3;N;5799919;666014;10196410;338747;16787;22549;0;81397;11321904;459480;5521985
1803;18;3;NlleA;8786807;255035;7724081;443859;450147;1191788;0;211018;10275928;2296812;1489121
1803;18;3;O;7708386;114839;3655586;692304;344745;3278764;-379206;120823;7827855;4057430;119469
1803;18;3;PACA;8084554;1676983;0;24781;255198;2120615;-4223;239793;4313147;2636164;-3771407
1803;18;3;PDL;5676003;1346627;0;406693;75688;6269;0;67379;1902656;556029;-3773347
1804;18;4;AURA;10255466;29859;12673740;205291;203708;5567914;-822803;155158;18012867;5309268;7757401
1804;18;4;B;3515962;3858;0;272523;45284;96493;-8023;60399;470534;466676;-3045428
1804;18;4;BFC;3238296;33281;0;228130;55712;162907;-10772;39791;509049;475768;-2729247
1804;18;4;CVDL;2754915;779;12367495;284537;57629;36821;0;83947;12831208;462934;10076293
1804;18;4;GE;7022682;484512;11822778;1028588;200822;1523442;-142342;123139;15040939;2733649;8018257
1804;18;4;HF;7686269;812213;4913473;1067915;28063;3159;0;176128;7000951;1275265;-685318
1804;18;4;IDF;10596491;6562;0;17068;16956;2030;0;202672;245288;238726;-10351203
1804;18;4;N;4371328;392151;10130826;232085;27397;27267;0;68140;10877866;354889;6506538
1804;18;4;NlleA;6535606;26581;6055204;238083;557614;905779;0;222210;8005471;1923686;1469865
1804;18;4;O;5737294;658;3175351;529255;428975;2969313;-360835;107706;6850423;3674414;1113129
1804;18;4;PACA;6142406;85828;0;17094;316651;2444063;-2046;283567;3145157;3059329;-2997249
1804;18;4;PDL;4257238;397471;0;206713;103205;5884;0;63946;777219;379748;-3480019
1805;18;5;AURA;9733911;28730;12770307;133935;212243;6881324;-709142;179915;19497312;6698275;9763401
1805;18;5;B;3065562;2947;0;195021;61176;96564;-9749;68746;414705;411758;-2650857
1805;18;5;BFC;3095127;39988;0;136912;65711;92641;-11070;39071;363253;323265;-2731874
1805;18;5;CVDL;2534588;168;13534768;209198;78163;26108;0;94053;13942458;407522;11407870
1805;18;5;GE;6721056;177818;13693073;705548;224536;1723794;-136877;137805;16525697;2654806;9804641
1805;18;5;HF;7358898;546094;4940785;771678;38024;2974;0;183012;6482567;995688;-876331
1805;18;5;IDF;10017979;2879;0;15726;23786;12068;0;206741;261200;258321;-9756779
1805;18;5;N;3882591;569057;7630757;141128;40092;25169;0;80382;8486585;286771;4603994
1805;18;5;NlleA;6190762;36286;6180858;172528;663918;777101;0;270466;8101157;1884013;1910395
1805;18;5;O;5400209;749;2369247;538202;443857;2951163;-424645;120528;5999101;3629105;598892
1805;18;5;PACA;5734071;89469;0;11256;319480;2644833;-4573;179656;3240121;3150652;-2493950
1805;18;5;PDL;3830653;122708;0;173508;143373;4305;0;70359;514253;391545;-3316400
1806;18;6;AURA;9406368;29847;12286027;123251;269152;6816996;-532206;165177;19158244;6842370;9751876
1806;18;6;B;2890127;4403;0;167000;55109;87261;-9789;63822;367806;363403;-2522321
1806;18;6;BFC;2981030;36208;0;132644;78459;122463;-4156;42395;408013;371805;-2573017
1806;18;6;CVDL;2451785;160;11388104;204994;76756;24764;0;80785;11775563;387299;9323778
1806;18;6;GE;6601479;251076;13629853;512157;222871;1624540;-129517;141759;16252739;2371810;9651260
1806;18;6;HF;7059951;736683;4467029;705687;36433;2869;0;167906;6116607;912895;-943344
1806;18;6;IDF;9532398;5709;0;11403;21790;11790;0;205271;255963;250254;-9276435
1806;18;6;N;3676450;710640;8373596;117074;37187;22678;0;72432;9333607;249371;5657157
1806;18;6;NlleA;5811363;33083;5732194;218225;733930;715795;0;262331;7695558;1930281;1884195
1806;18;6;O;5075703;145;1340877;379915;545608;3011929;-393384;100457;4985547;3644525;-90156
1806;18;6;PACA;5681784;171629;0;14547;379675;2622307;-2886;91603;3276875;3105246;-2404909
1806;18;6;PDL;3655290;123240;0;156583;135385;4343;0;63945;483496;360256;-3171794
1807;18;7;AURA;9953206;46119;11889220;97354;294293;5228437;-444663;167414;17278174;5342835;7324968
1807;18;7;B;2980862;6650;0;158284;61974;92467;-10908;70637;379104;372454;-2601758
1807;18;7;BFC;3062059;38662;0;94988;83737;35743;-3862;44607;293875;255213;-2768184
1807;18;7;CVDL;2607391;7;12379451;152943;82627;3595;0;82151;12700774;321316;10093383
1807;18;7;GE;6786650;1714025;11007660;478502;238696;1064683;-114235;157709;14547040;1825355;7760390
1807;18;7;HF;7234132;1516367;5044879;532336;40486;1670;0;183488;7319226;757980;85094
1807;18;7;IDF;9803622;12394;0;9404;24805;10192;0;239920;296715;284321;-9506907
1807;18;7;N;3821590;408272;10445091;98832;42025;19830;0;63192;11077242;223879;7255652
1807;18;7;NlleA;6449287;33747;7478769;135132;808474;323143;0;273565;9052830;1540314;2603543
1807;18;7;O;5802601;329;1642472;312511;612784;2069491;-327650;118651;4428588;2785787;-1374013
1807;18;7;PACA;6377183;251632;0;9937;433935;1640520;-411;159566;2495179;2243547;-3882004
1807;18;7;PDL;3833946;1065051;0;123938;148420;1903;0;59039;1398351;333300;-2435595
1808;18;8;AURA;9104205;120862;11576705;128852;266439;4201459;-541281;159435;15912471;4214904;6808266
1808;18;8;B;2933424;3961;0;125042;50536;99663;-10889;71556;339869;335908;-2593555
1808;18;8;BFC;2809038;41662;0;130374;77190;38102;-2991;43396;327733;286071;-2481305
1808;18;8;CVDL;2512564;1206;12065671;190727;78446;173;0;92675;12428898;362021;9916334
1808;18;8;GE;6179613;1283544;7253717;598685;219144;819409;-98182;152739;10229056;1691795;4049443
1808;18;8;HF;6707045;1570638;4473533;764499;36048;1247;0;190288;7036253;992082;329208
1808;18;8;IDF;8774904;27462;0;13139;21298;8708;0;212500;283107;255645;-8491797
1808;18;8;N;3634325;551018;10690183;137927;36396;17757;0;81395;11514676;273475;7880351
1808;18;8;NlleA;6262886;45909;7272384;170546;788672;135854;0;279004;8692369;1374076;2429483
1808;18;8;O;5669212;48;1234139;415752;554628;1287100;-389820;123617;3225464;1991277;-2443748
1808;18;8;PACA;6242113;399272;0;11162;390582;1143291;-70;157821;2102058;1702786;-4140055
1808;18;8;PDL;3562885;752501;0;123526;136374;88;0;57177;1069666;317165;-2493219
1809;18;9;AURA;9288809;112610;12561762;114554;241692;2762674;-762199;157209;15188302;2513930;5899493
1809;18;9;B;2917181;2755;0;238465;47049;96878;-9445;63739;439441;436686;-2477740
1809;18;9;BFC;2966722;89286;0;144478;68241;119708;-3708;44864;462869;373583;-2503853
1809;18;9;CVDL;2441994;14933;11187825;257932;68459;605;0;95933;11625687;422929;9183693
1809;18;9;GE;6575517;1501067;11174445;696463;200994;801282;-107707;134385;14400929;1725417;7825412
1809;18;9;HF;7279778;1086304;3520290;834726;30492;194;0;172891;5644897;1038303;-1634881
1809;18;9;IDF;9388124;2578;0;15077;18448;6766;0;198336;241205;238627;-9146919
1809;18;9;N;3835447;293671;11068804;182657;33418;16484;0;68479;11663513;301038;7828066
1809;18;9;NlleA;5899840;42880;7498590;202109;679627;221320;0;255045;8899571;1358101;2999731
1809;18;9;O;5183538;70;3151316;331576;492481;984183;-350684;111616;4720558;1569172;-462980
1809;18;9;PACA;5558798;532375;0;10011;352160;1011925;-58;209998;2116411;1584036;-3442387
1809;18;9;PDL;3619587;438710;0;199092;117699;0;0;59761;815262;376552;-2804325
1810;18;10;AURA;10468891;334087;12273292;224555;170203;2518799;-795290;175650;14901296;2293917;4432405
1810;18;10;B;3489947;9977;0;301279;36617;87719;-9585;54659;480666;470689;-3009281
1810;18;10;BFC;3417150;86283;0;229463;48836;38597;-1051;57067;459195;372912;-2957955
1810;18;10;CVDL;2812963;16574;10425740;361183;50409;881;0;97764;10952551;510237;8139588
1810;18;10;GE;7583688;2349859;13625632;1072003;174601;706516;-162519;123774;17889866;1914375;10306178
1810;18;10;HF;8283612;1356298;6215045;1197459;25260;18;0;163142;8957222;1385879;673610
1810;18;10;IDF;11068117;23320;0;20531;16542;7934;0;205402;273729;250409;-10794388
1810;18;10;N;4481372;299602;10113500;246395;26196;17088;0;74980;10777761;364659;6296389
1810;18;10;NlleA;6607582;97338;6776030;311427;447693;181880;0;253219;8067587;1194219;1460005
1810;18;10;O;5618566;2874;3683649;717267;311461;1191729;-408134;123884;5622730;1936207;4164
1810;18;10;PACA;5668465;1632700;0;21952;224527;1040198;0;141729;3061106;1428406;-2607359
1810;18;10;PDL;4205672;1068821;0;278894;86840;0;0;65129;1499684;430863;-2705988
1811;18;11;AURA;11859721;646305;11844431;196184;93800;3284314;-842600;191017;15413451;2922715;3553730
1811;18;11;B;4276330;265444;0;387868;22896;84459;-9472;55006;806201;540757;-3470129
1811;18;11;BFC;3942623;218969;0;243130;27552;20980;-1373;62852;572110;353141;-3370513
1811;18;11;CVDL;3502638;117673;9156129;379514;26078;2390;0;85553;9767337;493535;6264699
1811;18;11;GE;8414776;2699985;16734485;1242779;98215;579497;-97252;141884;21399593;1965123;12984817
1811;18;11;HF;9431974;2498106;6040036;1523517;14788;709;0;164507;10241663;1703521;809689
1811;18;11;IDF;13516718;705830;0;21511;9722;7785;0;214526;959374;253544;-12557344
1811;18;11;N;5257683;568176;8770923;331594;15719;17780;0;71322;9775514;436415;4517831
1811;18;11;NlleA;8041321;335496;9116748;334732;280691;207192;0;269920;10544779;1092535;2503458
1811;18;11;O;6789868;111471;3620286;588360;197504;1924472;-393388;128189;6176894;2445137;-612974
1811;18;11;PACA;6839564;2095813;0;16564;124679;1659677;-60;129458;4026131;1930318;-2813433
1811;18;11;PDL;5131683;804846;0;347405;52941;677;0;66263;1272132;467286;-3859551
1812;18;12;AURA;13299809;492106;16679328;240274;51410;4902317;-802108;211450;21774777;4603343;8474968
1812;18;12;B;4568087;334714;0;426490;5003;103228;-11338;63168;921265;586551;-3646822
1812;18;12;BFC;4178790;261738;0;367380;10805;144722;-8703;54840;830782;569044;-3348008
1812;18;12;CVDL;3951125;122834;13741118;534174;11981;6508;0;85392;14502007;638055;10550882
1812;18;12;GE;8704296;1684510;17494082;1775369;39259;1274357;-90312;161654;22338919;3160327;13634623
1812;18;12;HF;9823414;1972364;7869697;1967569;3340;2862;0;165727;11981559;2139498;2158145
1812;18;12;IDF;14497978;698253;0;30475;1766;13342;0;230363;974199;275946;-13523779
1812;18;12;N;5618630;640678;8942605;435375;4167;26974;0;71450;10121249;537966;4502619
1812;18;12;NlleA;8572840;316690;9476423;440371;132693;411645;0;285750;11063572;1270459;2490732
1812;18;12;O;7691706;130777;3527606;652906;146225;1701812;-411829;131749;5879246;2220863;-1812460
1812;18;12;PACA;8159932;1530329;0;15670;144282;1639509;-6432;158363;3481721;1951392;-4678211
1812;18;12;PDL;5473773;697004;0;435980;15451;3961;0;66301;1218697;521693;-4255076
1901;19;1;AURA;15130581;819918;18063152;228775;77510;4532570;-630887;203536;23294574;4411504;8163993
1901;19;1;B;5117752;400584;0;265501;15118;93909;-11113;55557;819556;418972;-4298196
1901;19;1;BFC;4819653;253071;0;246547;18625;198650;-11263;45774;751404;498333;-4068249
1901;19;1;CVDL;4518435;171946;15320602;453529;18528;10518;0;80310;16055433;562885;11536998
1901;19;1;GE;9752928;2765429;16911118;1350318;57231;1201157;-97931;167185;22354507;2677960;12601579
1901;19;1;HF;10754090;2771666;8069581;1576199;8485;2973;0;184104;12613008;1771761;1858918
1901;19;1;IDF;16177195;777129;0;21788;5491;12500;0;224779;1041687;264558;-15135508
1901;19;1;N;6216673;724826;8502061;290084;9193;20954;0;80050;9627168;400281;3410495
1901;19;1;NlleA;10253943;418888;9623274;382584;195322;404377;0;295196;11319641;1277479;1065698
1901;19;1;O;9308689;135972;3798223;927430;196042;1701622;-291440;132360;6600209;2666014;-2708480
1901;19;1;PACA;9320482;2341700;0;35870;195081;1715687;-10119;143920;4422139;2080439;-4898343
1901;19;1;PDL;6224419;1054022;0;293168;37750;5737;0;71540;1462217;408195;-4762202
1902;19;2;AURA;12379092;520948;16307375;179103;157446;4440584;-522309;180541;21263688;4435365;8884596
1902;19;2;B;4252816;352961;0;319278;29687;96895;-9607;62387;851601;498640;-3401215
1902;19;2;BFC;4034953;230692;0;259136;46312;194154;-11128;60679;779845;549153;-3255108
1902;19;2;CVDL;3638640;131448;15343021;369849;43722;22969;0;73344;15984353;509884;12345713
1902;19;2;GE;8269775;1986428;13672891;1147843;130115;1066173;-85188;155018;18073280;2413961;9803505
1902;19;2;HF;9026663;2157619;6669362;1470302;19613;2711;0;157632;10477239;1650258;1450576
1902;19;2;IDF;13270272;597053;0;18472;11889;12078;0;198631;838123;241070;-12432149
1902;19;2;N;5205339;872367;8948994;303222;20865;24572;0;57819;10227839;406478;5022500
1902;19;2;NlleA;8045010;354833;8684012;345509;435766;661904;0;266141;10748165;1709320;2703155
1902;19;2;O;7241608;119909;2517438;525350;333088;1843204;-267577;126180;5197592;2560245;-2044016
1902;19;2;PACA;7577774;1627503;0;12765;258963;1602235;-10097;144136;3635505;2008002;-3942269
1902;19;2;PDL;5142012;686177;0;305386;73717;5277;0;63474;1134031;447854;-4007981
1903;19;3;AURA;12082635;329773;14987816;281422;223742;4804368;-742192;197084;20082013;4764424;7999378
1903;19;3;B;4227543;372119;0;508393;41981;88712;-8239;69986;1072952;700833;-3154591
1903;19;3;BFC;3986374;200649;0;473353;64422;238470;-11712;70603;1035785;835136;-2950589
1903;19;3;CVDL;3555928;139456;14449595;659264;60009;19060;0;80838;15408222;819171;11852294
1903;19;3;GE;8293284;1052469;13791032;2180987;172144;1449380;-109474;174732;18711270;3867769;10417986
1903;19;3;HF;9234302;1522249;6478947;2419955;26015;2978;0;177618;10627762;2626566;1393460
1903;19;3;IDF;12865608;531374;0;38433;16538;14703;0;209998;811046;279672;-12054562
1903;19;3;N;5194136;625625;10739314;472785;27346;25310;0;75627;11966007;601068;6771871
1903;19;3;NlleA;7771166;315945;8337710;502447;620307;688242;0;299746;10764397;2110742;2993231
1903;19;3;O;6661466;117468;2255055;797153;479255;1655181;-258970;144217;5189359;2816836;-1472107
1903;19;3;PACA;6932630;934120;0;20703;379920;1322715;-17966;152347;2791839;1857719;-4140791
1903;19;3;PDL;5079399;451903;0;500681;105237;6890;0;73034;1137745;685842;-3941654
1904;19;4;AURA;10530478;110386;11828424;207073;228791;3974788;-596071;158213;15911604;3972794;5381126
1904;19;4;B;3705935;5651;0;273436;48386;90703;-9366;68236;477046;471395;-3228889
1904;19;4;BFC;3451989;86701;0;230886;69833;145583;-12807;68419;588615;501914;-2863374
1904;19;4;CVDL;2957896;16902;13119565;339921;70563;6253;0;86302;13639506;503039;10681610
1904;19;4;GE;7358202;1178627;12046603;1004430;191914;1236650;-88393;162715;15732546;2507316;8374344
1904;19;4;HF;8040472;1245475;5234023;1106543;31642;3710;0;169606;7790999;1311501;-249473
1904;19;4;IDF;10975545;3980;0;19450;18880;14327;0;166371;223008;219028;-10752537
1904;19;4;N;4524840;448244;10359165;223179;35256;23204;0;59689;11148737;341328;6623897
1904;19;4;NlleA;6835790;24105;7421788;261421;628133;570932;0;268003;9174382;1728489;2338592
1904;19;4;O;6102197;1008;3457810;679461;456932;1634734;-85708;116629;6260866;2802048;158669
1904;19;4;PACA;6492374;842775;0;19845;343930;1285411;-6876;114948;2600033;1757258;-3892341
1904;19;4;PDL;4402308;312042;0;277262;118751;4609;0;68662;781326;469284;-3620982
1905;19;5;AURA;10088067;88932;13076357;240074;279050;5001396;-677721;186155;18194243;5028954;8106176
1905;19;5;B;3268100;2288;0;211598;61091;95231;-11562;73281;431927;429639;-2836173
1905;19;5;BFC;3342931;38702;0;244113;85211;140163;-7100;52185;553274;514572;-2789657
1905;19;5;CVDL;2725839;10553;12730185;324412;79908;8264;0;93569;13246891;506153;10521052
1905;19;5;GE;7108776;1067291;9891825;898421;221408;1639718;-95750;165560;13788473;2829357;6679697
1905;19;5;HF;7756132;830725;4981259;974505;40102;3305;0;174561;7004457;1192473;-751675
1905;19;5;IDF;10536657;186;0;20763;23509;14233;0;191241;249932;249746;-10286725
1905;19;5;N;4224274;415889;11251881;185196;43042;20304;0;73580;11989892;322122;7765618
1905;19;5;NlleA;6394524;38046;8106647;246770;760749;661595;0;278251;10092058;1947365;3697534
1905;19;5;O;5429410;152;3253199;787249;577501;1910361;-407282;124399;6245579;2992228;816169
1905;19;5;PACA;5942334;1036442;0;23995;427454;1533587;-930;157019;3177567;2141125;-2764767
1905;19;5;PDL;3952314;366283;0;259928;146870;2973;0;72770;848824;482541;-3103490
1906;19;6;AURA;9237268;166096;13183653;140851;299998;5751142;-591802;146707;19096645;5746896;9859377
1906;19;6;B;2965795;2668;0;190746;60988;95383;-13090;64860;401555;398887;-2564240
1906;19;6;BFC;2960964;34434;0;198208;90184;76073;-180;42692;441411;406977;-2519553
1906;19;6;CVDL;2463891;23;11014543;280921;85828;5376;0;83676;11470367;455801;9006476
1906;19;6;GE;6478048;857071;8778473;815737;233407;1815855;-91836;157035;12565742;2930198;6087694
1906;19;6;HF;7000220;1035677;3494934;1024796;43096;1309;0;174451;5774263;1243652;-1225957
1906;19;6;IDF;9490945;2002;0;17929;25459;9531;0;181213;236134;234132;-9254811
1906;19;6;N;3743420;321397;10308942;191818;44289;17605;0;76462;10960513;330174;7217093
1906;19;6;NlleA;5904616;37685;7787773;216401;798583;462030;0;228794;9531266;1705808;3626650
1906;19;6;O;5079345;149;2509458;439627;607888;1645066;-391376;116768;4927580;2417973;-151765
1906;19;6;PACA;5845885;805775;0;10080;451787;1655416;-131;123578;3046505;2240730;-2799380
1906;19;6;PDL;3601661;190352;0;213282;155689;2105;0;74512;635940;445588;-2965721
1907;19;7;AURA;9821378;235038;15105197;117458;330950;4583920;-411201;166678;20128040;4787805;10306662
1907;19;7;B;3052792;4241;0;209407;69154;97362;-13543;73868;440489;436248;-2612303
1907;19;7;BFC;3068285;39380;0;186997;100949;32542;-288;41901;401481;362101;-2666804
1907;19;7;CVDL;2690267;644;10349557;273976;95338;314;0;89609;10809438;459237;8119171
1907;19;7;GE;6672951;1610275;8822800;710704;242185;1557200;-86304;170827;13027687;2594612;6354736
1907;19;7;HF;7207000;1536342;4855205;866571;44331;495;0;191032;7493976;1102429;286976
1907;19;7;IDF;9509833;33271;0;18561;27576;6686;0;223837;309931;276660;-9199902
1907;19;7;N;3798599;366365;8938548;165342;49763;8705;0;50404;9579127;274214;5780528
1907;19;7;NlleA;6468285;33925;7454926;187351;877242;148269;0;248611;8950324;1461473;2482039
1907;19;7;O;5960277;93;2823236;429507;644202;1055004;-281601;134862;4805303;1981974;-1154974
1907;19;7;PACA;6645273;1236239;0;9928;454905;1277665;-3413;130671;3105995;1869756;-3539278
1907;19;7;PDL;3862196;509993;0;228374;165320;112;0;71408;975207;465214;-2886989
1908;19;8;AURA;8707992;142852;13884195;116522;303523;3496960;-546731;176961;17574282;3547235;8866290
1908;19;8;B;2935298;2780;0;219465;59658;102224;-12283;73804;445648;442868;-2489650
1908;19;8;BFC;2632575;61219;0;161948;91208;59232;-5299;36510;404818;343599;-2227757
1908;19;8;CVDL;2480402;17148;10917294;270016;85047;600;0;94867;11384972;450530;8904570
1908;19;8;GE;5996497;1059808;9881134;662315;230242;1616167;-182575;176816;13443907;2502965;7447410
1908;19;8;HF;6569900;1342117;4705588;906017;40638;127;0;188410;7182897;1135192;612997
1908;19;8;IDF;8388083;27027;0;24420;24344;4338;0;201350;281479;254452;-8106604
1908;19;8;N;3529743;409130;7205935;186629;45031;11031;0;81089;7938845;323780;4409102
1908;19;8;NlleA;6038411;27593;5714163;175411;810224;118732;0;268396;7114519;1372763;1076108
1908;19;8;O;5490014;84;3091286;327217;615240;954312;-324731;143470;4806878;1715508;-683136
1908;19;8;PACA;6382140;690992;0;11285;419671;1107522;-13631;241665;2457504;1766512;-3924636
1908;19;8;PDL;3483464;370466;0;209594;145138;29;0;75761;800988;430522;-2682476
1909;19;9;AURA;9041803;329826;13765997;151247;257314;2228456;-663794;161862;16230908;2135085;7189105
1909;19;9;B;2957098;3048;0;338930;48800;95796;-10844;68298;544028;540980;-2413070
1909;19;9;BFC;2958318;80989;0;270389;78343;77949;-10299;33354;530725;449736;-2427593
1909;19;9;CVDL;2527181;19935;9926160;435442;71027;700;0;93550;10546814;600719;8019633
1909;19;9;GE;6428200;1765444;10160238;1162901;203050;1221511;-166855;157450;14503739;2578057;8075539
1909;19;9;HF;7071992;1354675;4533314;1411469;32681;100;0;168029;7500268;1612279;428276
1909;19;9;IDF;9067077;34266;0;39304;22992;6901;0;187954;291417;257151;-8775660
1909;19;9;N;3696379;346582;6238647;286154;35715;10624;0;72807;6990529;405300;3294150
1909;19;9;NlleA;5775967;27063;7120560;276279;669914;184644;0;269648;8548108;1400485;2772141
1909;19;9;O;5179949;545;3278212;498914;508198;658334;-224644;107591;4827150;1548393;-352799
1909;19;9;PACA;5699181;1166660;0;13662;355188;660844;-14555;162275;2344074;1177414;-3355107
1909;19;9;PDL;3613353;459327;0;349308;122450;0;0;64789;995874;536547;-2617479
1910;19;10;AURA;9798793;459213;14503418;234159;160189;3676592;-766674;152298;18419195;3456564;8620402
1910;19;10;B;3558167;3879;0;372940;29595;100272;-9878;63899;560707;556828;-2997460
1910;19;10;BFC;3370382;69287;0;368541;42772;150135;-9702;35864;656897;587610;-2713485
1910;19;10;CVDL;2829808;32520;9477772;533252;39055;3202;0;85794;10171595;661303;7341787
1910;19;10;GE;7461363;1777919;15522351;1615404;160619;1425886;-147436;166188;20520931;3220661;13059568
1910;19;10;HF;8164298;1845694;3886085;1839429;21034;1184;0;182001;7775427;2043648;-388871
1910;19;10;IDF;11089626;103338;0;46065;14803;9833;0;203718;377757;274419;-10711869
1910;19;10;N;4331576;230649;4662088;377767;21886;17254;0;81476;5391120;498383;1059544
1910;19;10;NlleA;6362243;88443;8255909;330805;411168;217623;0;243983;9547931;1203579;3185688
1910;19;10;O;5331857;1243;1906969;648096;334034;921854;-86359;119138;3844975;1936763;-1486882
1910;19;10;PACA;5801561;1244533;0;16442;251162;1053786;-6088;125487;2685322;1440789;-3116239
1910;19;10;PDL;4157836;458336;0;344214;73107;1489;0;80535;957681;499345;-3200155
1911;19;11;AURA;11591964;674309;11942292;213651;92699;5623832;-729017;185179;18002945;5386344;6410981
1911;19;11;B;4407354;306433;0;420181;19798;109999;-10000;63255;909666;603233;-3497688
1911;19;11;BFC;3872016;232346;0;375896;26187;181661;-6487;36507;846110;613764;-3025906
1911;19;11;CVDL;3524463;131071;10077763;550632;24946;26022;0;85177;10895611;686777;7371148
1911;19;11;GE;8405857;2375329;16162826;1593981;94727;1403310;-171368;175605;21634410;3096255;13228553
1911;19;11;HF;9179722;2397548;4820497;1680180;12940;3020;0;185097;9099282;1881237;-80440
1911;19;11;IDF;13451751;694625;0;45747;9261;12497;0;202316;964446;269821;-12487305
1911;19;11;N;5235455;779565;5272987;342794;14339;28863;0;84269;6522817;470265;1287362
1911;19;11;NlleA;8199106;288594;8150393;399429;212666;943875;0;245540;10240497;1801510;2041391
1911;19;11;O;6990223;103211;1812390;644344;214889;2501354;-303974;134655;5106869;3191268;-1883354
1911;19;11;PACA;7329701;2060806;0;14343;147293;1942800;-60;137836;4303018;2242212;-3026683
1911;19;11;PDL;5210524;1206100;0;412364;45793;3662;0;77273;1745192;539092;-3465332
1912;19;12;AURA;12566015;542389;14918510;275070;93716;6431931;-850544;205670;21616742;6155843;9050727
1912;19;12;B;4810366;371879;0;548441;17732;117467;-11869;71260;1114910;743031;-3695456
1912;19;12;BFC;4068023;237270;0;522854;25927;291602;-3100;47721;1122274;885004;-2945749
1912;19;12;CVDL;3840347;156215;10477697;683448;24466;65552;0;87338;11494716;860804;7654369
1912;19;12;GE;8879448;1774409;17003674;2192692;59632;1534871;-187670;183599;22561207;3783124;13681759
1912;19;12;HF;9633354;1834345;6426224;2619626;11785;3172;0;189469;11084621;2824052;1451267
1912;19;12;IDF;14392704;577622;0;59181;8790;6144;0;197445;849182;271560;-13543522
1912;19;12;N;5678876;725455;6021742;524773;13447;25353;0;88593;7399363;652166;1720487
1912;19;12;NlleA;8662433;290939;7927446;522760;202156;1384414;0;248245;10575960;2357575;1913527
1912;19;12;O;7397391;135228;3151221;799774;194949;3368647;-391933;136218;7394104;4107655;-3287
1912;19;12;PACA;7841643;1293581;0;18481;157814;2274315;-4565;153650;3893276;2599695;-3948367
1912;19;12;PDL;5637246;812239;0;551241;42866;5072;0;81368;1492786;680547;-4144460
2001;20;1;AURA;13645505;678679;16760424;242538;102009;5261088;-610720;205981;22639999;5200896;8994494
2001;20;1;B;4910735;378047;0;505643;17834;118674;-14358;73867;1079707;701660;-3831028
2001;20;1;BFC;4388881;253129;0;417443;28046;186540;-7896;64248;941510;688381;-3447371
2001;20;1;CVDL;4094049;181835;13900677;663914;27981;35193;0;85899;14895499;812987;10801450
2001;20;1;GE;9123842;2250625;17271565;1855870;39894;1132907;-181203;178338;22547996;3025806;13424154
2001;20;1;HF;10113598;2600139;6211163;2338976;9926;3771;0;187411;11351386;2540084;1237788
2001;20;1;IDF;15081765;520461;0;53202;7574;8372;0;198516;788125;267664;-14293640
2001;20;1;N;5919292;713640;8550293;429851;12608;28057;0;85697;9820146;556213;3900854
2001;20;1;NlleA;9184553;337857;8357006;565648;256585;844303;0;251095;10612494;1917631;1427941
2001;20;1;O;8200410;136470;3615434;690887;214781;2594363;-240948;138330;7149317;3397413;-1051093
2001;20;1;PACA;8389934;1876131;0;14204;154686;2314834;-10528;160659;4509986;2633855;-3879948
2001;20;1;PDL;5827760;1001495;0;546766;45315;7721;0;79124;1680421;678926;-4147339
2002;20;2;AURA;12012413;465782;15287282;291133;150917;5312135;-842572;183875;20848552;5095488;8836139
2002;20;2;B;4348267;373377;0;679477;25581;115586;-10852;68922;1252091;878714;-3096176
2002;20;2;BFC;3881479;217726;0;588801;39663;261253;-10854;67386;1163975;946249;-2717504
2002;20;2;CVDL;3652424;147864;13007107;953547;40633;42139;0;78443;14269733;1114762;10617309
2002;20;2;GE;8109817;1398560;12197069;2814999;61962;1466413;-148800;163291;17953494;4357865;9843677
2002;20;2;HF;9214056;1652275;5704076;3655028;15386;2611;0;168364;11197740;3841389;1983684
2002;20;2;IDF;12858920;434128;0;75125;11296;3406;0;159199;683154;249026;-12175766
2002;20;2;N;5257349;594701;8139946;645742;17955;17973;0;82097;9498414;763767;4241065
2002;20;2;NlleA;7868710;316037;8817449;619636;386942;772810;0;281994;11194868;2061382;3326158
2002;20;2;O;6689671;127772;3159157;755636;326776;2010695;-354092;124728;6150672;2863743;-538999
2002;20;2;PACA;7228841;1192688;0;15965;244749;2522278;-14377;137522;4098825;2906137;-3130016
2002;20;2;PDL;5109745;690520;0;687262;65291;6534;0;74287;1523894;833374;-3585851
2003;20;3;AURA;11075641;441257;12745041;191246;226163;6028942;-650827;185870;19167692;5981394;8092051
2003;20;3;B;4259076;384170;0;514525;40624;117022;-11230;73304;1118415;734245;-3140661
2003;20;3;BFC;3597213;229636;0;432869;63825;243756;-8349;67182;1028919;799283;-2568294
2003;20;3;CVDL;3449396;148623;13914778;727154;65375;45273;0;84282;14985485;922084;11536089
2003;20;3;GE;7580535;1257796;8363976;2175531;106609;1586416;-136392;178411;13532347;3910575;5951812
2003;20;3;HF;8862691;1641255;6664727;2666638;25772;2724;0;191887;11193003;2887021;2330312
2003;20;3;IDF;12390543;568257;0;59353;18070;1945;0;207550;855175;286918;-11535368
2003;20;3;N;5129023;541085;7967481;467483;31096;10079;0;82358;9099582;591016;3970559
2003;20;3;NlleA;7711369;272816;8184197;478727;542330;1188714;0;300894;10967678;2510665;3256309
2003;20;3;O;6552556;113915;3429620;733039;441857;2794236;-317325;128907;7324249;3780714;771693
2003;20;3;PACA;6988273;1116284;0;18391;330854;2548234;-5036;159753;4168480;3052196;-2819793
2003;20;3;PDL;4969833;507112;0;533300;106990;7405;0;80146;1234953;727841;-3734880
2004;20;4;AURA;8481915;36201;10771728;134185;284897;4664632;-634594;153598;15410647;4602718;6928732
2004;20;4;B;3038253;3353;0;255253;54189;97092;-10911;70883;469859;466506;-2568394
2004;20;4;BFC;2743563;41779;0;233189;86515;71115;-13897;65588;484289;442510;-2259274
2004;20;4;CVDL;2507165;11004;12485598;353105;91362;14392;0;91284;13046745;550143;10539580
2004;20;4;GE;5651194;116412;7153631;1068743;156770;1053161;-155960;167074;9559831;2289788;3908637
2004;20;4;HF;6595903;427553;6170223;1215465;39023;2883;0;178902;8034049;1436273;1438146
2004;20;4;IDF;8533838;2717;0;30923;26721;11094;0;198985;270440;267723;-8263398
2004;20;4;N;3692016;276415;6924501;202626;44289;24284;0;80179;7552294;351378;3860278
2004;20;4;NlleA;5639717;27686;7158663;287446;656815;618148;0;272005;9020763;1834414;3381046
2004;20;4;O;5022473;2243;2957729;478864;514467;2032706;-309617;124111;5800503;2840531;778030
2004;20;4;PACA;5443185;182065;0;5248;388797;1486425;-17863;148153;2192825;2010760;-3250360
2004;20;4;PDL;3594376;14693;0;281887;141594;4901;0;78109;521184;506491;-3073192
2005;20;5;AURA;8559714;64340;10772140;192805;332234;5949408;-716514;172693;16767106;5930626;8207392
2005;20;5;B;2877911;3122;0;302750;72312;93274;-11795;77432;537095;533973;-2340816
2005;20;5;BFC;2892255;64267;0;282352;95367;81276;-13773;68728;578217;513950;-2314038
2005;20;5;CVDL;2436052;7325;11837666;428140;109056;31241;0;97963;12511391;666400;10075339
2005;20;5;GE;5934227;476772;6300618;1062694;174931;1355696;-122870;175950;9423791;2646401;3489564
2005;20;5;HF;6757783;763944;6269470;1447365;47525;3273;0;176112;8707689;1674275;1949906
2005;20;5;IDF;8779529;3044;0;34806;32761;10285;0;191905;272801;269757;-8506728
2005;20;5;N;3605623;290845;6125464;243566;56546;24428;0;80030;6820879;404570;3215256
2005;20;5;NlleA;5610886;25387;4834995;404932;862694;751904;0;264459;7144371;2283989;1533485
2005;20;5;O;4750882;133;3265431;538768;642128;2450843;-356589;119823;6660537;3394973;1909655
2005;20;5;PACA;5135655;401109;0;15928;444152;2539474;-19967;157093;3537789;3136680;-1597866
2005;20;5;PDL;3607957;295317;0;354254;179799;3688;0;80702;913760;618443;-2694197
2006;20;6;AURA;8690956;402861;9951524;130175;311406;5851877;-478856;164678;16333665;5979280;7642709
2006;20;6;B;2903652;16436;0;212195;60062;89366;-11367;64020;430712;414276;-2472940
2006;20;6;BFC;2768707;83678;0;189854;85573;83639;-12071;63953;494626;410948;-2274081
2006;20;6;CVDL;2361596;7233;7033818;314891;92783;8418;0;86596;7543739;502688;5182143
2006;20;6;GE;6115850;1313338;8097534;851652;155085;1395609;-93975;180822;11900065;2489193;5784215
2006;20;6;HF;6635385;1045101;4783044;1132039;41642;2783;0;171885;7176494;1348349;541109
2006;20;6;IDF;8791958;150102;0;25706;29179;6583;0;210903;422473;272371;-8369485
2006;20;6;N;3502876;271849;5992077;199336;48460;16772;0;84403;6612897;348971;3110021
2006;20;6;NlleA;5652101;23446;3421125;258098;825803;470541;0;264607;5263620;1819049;-388481
2006;20;6;O;4907866;37;3365879;494159;626557;2089239;-226112;95731;6445490;3079574;1537624
2006;20;6;PACA;5359942;1109020;0;16041;468907;2705909;-8928;121327;4412276;3303256;-947666
2006;20;6;PDL;3522255;438327;0;263822;149098;1635;0;78877;931759;493432;-2590496
2007;20;7;AURA;9211028;479749;10922463;122423;371106;4797223;-269459;157880;16581385;5179173;7370357
2007;20;7;B;3036916;38041;0;215087;68739;97493;-14732;76964;481592;443551;-2555324
2007;20;7;BFC;2895130;47715;0;173166;103739;48438;-11527;75221;436752;389037;-2458378
2007;20;7;CVDL;2585150;14383;7737854;310751;115824;2778;0;92979;8274569;522332;5689419
2007;20;7;GE;6388860;577971;8717993;842270;176917;1364167;0;184129;11863447;2567483;5474587
2007;20;7;HF;6970918;1478319;4688174;1313239;45306;1476;0;172835;7699349;1532856;728431
2007;20;7;IDF;8816794;216918;0;27713;36353;5644;0;229575;516203;299285;-8300591
2007;20;7;N;3620671;356004;5213700;223685;55095;15339;0;86236;5950059;380355;2329388
2007;20;7;NlleA;6336333;67474;4364242;218713;958132;172233;0;263339;6044133;1612417;-292200
2007;20;7;O;5737829;189;3324020;500987;716824;1184441;-222641;117197;5621017;2296808;-116812
2007;20;7;PACA;6174154;1315110;0;14092;505756;1522091;-10801;117123;3463371;2148261;-2710783
2007;20;7;PDL;3743587;746755;0;235380;182113;87;0;82326;1246661;499906;-2496926
2008;20;8;AURA;8495491;420815;11331068;129635;325290;3853851;-563044;144607;15642222;3890339;7146731
2008;20;8;B;2950003;10620;0;235910;60723;94718;-13258;79581;468294;457674;-2481709
2008;20;8;BFC;2713056;34705;0;176856;90726;37946;-8841;44148;375540;340835;-2337516
2008;20;8;CVDL;2432904;15821;8050281;315143;98333;2730;0;97069;8579377;513275;6146473
2008;20;8;GE;5871867;731927;9503812;833596;156859;1201975;0;183360;12611529;2375790;6739662
2008;20;8;HF;6460555;1713356;5499603;1204562;42526;675;0;182376;8643098;1430139;2182543
2008;20;8;IDF;8598640;75907;0;28160;34744;5056;0;200453;344320;268413;-8254320
2008;20;8;N;3459341;352089;5415257;222755;47226;14059;0;84293;6135679;368333;2676338
2008;20;8;NlleA;6108069;16797;3835623;217383;828301;107420;0;258103;5263627;1411207;-844442
2008;20;8;O;5572031;89;2090389;489552;642515;957522;-238680;124965;4066352;1975874;-1505679
2008;20;8;PACA;6229002;1333977;0;11992;471423;1071433;-8103;123583;3004305;1670328;-3224697
2008;20;8;PDL;3487272;348274;0;215622;154857;140;0;85667;804560;456286;-2682712
2009;20;9;AURA;9028352;486397;12866038;133737;268606;3302040;-652996;155810;16559632;3207197;7531280
2009;20;9;B;3060315;18229;0;204345;48476;92163;-11628;75302;426887;408658;-2633428
2009;20;9;BFC;2929911;82624;0;217110;78272;93640;-5934;42269;507981;425357;-2421930
2009;20;9;CVDL;2474823;22323;8252853;345405;84550;1948;0;79860;8786939;511763;6312116
2009;20;9;GE;6354101;1207149;7449666;875827;126311;1099919;-6;167200;10926066;2269251;4571965
2009;20;9;HF;7076604;1909392;4264484;1309953;34626;100;0;166852;7685407;1511531;608803
2009;20;9;IDF;9190950;178868;0;31031;29552;5232;0;234787;479470;300602;-8711480
2009;20;9;N;3688722;761069;5214697;212091;39585;11437;0;80447;6319326;343560;2630604
2009;20;9;NlleA;5942725;64970;4369699;235651;693716;220444;0;212692;5797172;1362503;-145553
2009;20;9;O;5213761;264;1049417;475181;516308;911182;-198810;98854;2852396;1802715;-2361365
2009;20;9;PACA;5614584;906993;0;10534;361297;958998;-6840;105646;2336628;1429635;-3277956
2009;20;9;PDL;3648146;107015;0;227259;127221;136;0;78779;540410;433395;-3107736
2010;20;10;AURA;10583380;316964;14084964;246584;153538;4536981;-789438;150464;18700057;4298129;8116677
2010;20;10;B;3777234;10912;0;448284;31640;97133;-8804;71878;651043;640131;-3126191
2010;20;10;BFC;3560559;84597;0;436988;39452;99818;-8105;49873;702623;618026;-2857936
2010;20;10;CVDL;3096644;31217;9554587;655718;44072;15298;0;83757;10384649;798845;7288005
2010;20;10;GE;7544078;1189706;13156663;2048300;67005;1361201;-41644;178112;17959343;3612974;10415265
2010;20;10;HF;8198412;1621958;3954073;2563637;19404;1087;0;170803;8330962;2754931;132550
2010;20;10;IDF;11209370;8950;0;61001;16065;9838;0;144629;240483;231533;-10968887
2010;20;10;N;4488471;392310;6669396;420752;23622;17626;0;90069;7613775;552069;3125304
2010;20;10;NlleA;7050454;79157;7259808;489838;418427;649402;0;221595;9118227;1779262;2067773
2010;20;10;O;6026045;2667;1764998;749401;329995;1827497;-279821;112259;4506996;2739331;-1519049
2010;20;10;PACA;6236618;826458;0;20762;286698;1604907;-17458;132965;2854332;2027874;-3382286
2010;20;10;PDL;4434486;302826;0;478704;75848;1143;0;72550;931071;628245;-3503415
2011;20;11;AURA;10921150;633689;13499445;197306;140221;3933622;-652928;192841;17944196;3811062;7023046
2011;20;11;B;3914574;293470;0;384481;25630;105137;-12152;68568;865134;571664;-3049440
2011;20;11;BFC;3605178;197114;0;298469;40566;112567;-8494;66941;707163;510049;-2898015
2011;20;11;CVDL;3335215;110468;12225784;432732;43183;11365;0;76399;12899931;563679;9564716
2011;20;11;GE;7855545;1438905;14781708;1294283;60512;1173776;-145216;176518;18780486;2559873;10924941
2011;20;11;HF;8477541;2110477;5462644;1911968;14936;1536;0;173655;9675216;2102095;1197675
2011;20;11;IDF;11734080;527260;0;39310;13178;10240;0;159745;749733;222473;-10984347
2011;20;11;N;4767121;602295;8629605;351460;17056;19233;0;91610;9711259;479359;4944138
2011;20;11;NlleA;7266504;257787;7068878;399632;394162;511240;0;218399;8850098;1523433;1583594
2011;20;11;O;6201085;90479;1439433;625645;272515;1735156;-257447;118819;4024600;2494688;-2176485
2011;20;11;PACA;6547878;1829444;0;24424;208063;1386979;-16230;131881;3564561;1735117;-2983317
2011;20;11;PDL;4645682;648786;0;383789;67872;3199;0;80938;1184584;535798;-3461098
2012;20;12;AURA;12912765;587604;15321447;283586;69316;5036139;-803200;188031;20682923;4773872;7770158
2012;20;12;B;4807904;362511;0;540164;16952;119182;-14623;72498;1096684;734173;-3711220
2012;20;12;BFC;4249664;203932;0;440038;18721;170671;-8681;59390;884071;680139;-3365593
2012;20;12;CVDL;3992837;127423;13452932;733848;20219;44779;0;88888;14468089;887734;10475252
2012;20;12;GE;8607872;1555574;13661336;1837717;28412;1248213;-148270;177967;18360949;3144039;9753077
2012;20;12;HF;9397460;2081014;5534696;2459114;10124;2170;0;190064;10277182;2661472;879722
2012;20;12;IDF;14023351;824480;0;64561;7535;8206;0;177370;1082152;257672;-12941199
2012;20;12;N;5618656;750006;9152442;472201;10390;22792;0;85749;10493580;591132;4874924
2012;20;12;NlleA;9059677;269810;8734907;644417;184556;957240;0;246466;11037396;2032679;1977719
2012;20;12;O;8275170;129654;2967969;751373;154871;2273115;-264927;125280;6137335;3039712;-2137835
2012;20;12;PACA;8298532;1705088;0;22507;129139;1498154;-19125;160515;3496278;1791190;-4802254
2012;20;12;PDL;5542368;1038515;0;581964;39759;6623;0;68175;1735036;696521;-3807332
2101;21;1;AURA;14540073;703232;15669238;240713;78605;6276703;-596523;187602;22559570;6187100;8019497
2101;21;1;B;5328985;378178;0;408103;15986;123135;-13500;70757;982659;604481;-4346326
2101;21;1;BFC;4670538;215389;0;448096;19169;318196;-2321;64535;1063064;847675;-3607474
2101;21;1;CVDL;4402994;176455;14866294;625845;24745;59605;0;89180;15842124;799375;11439130
2101;21;1;GE;9482059;1963769;13261280;1739907;26940;1302384;-152523;185142;18326899;3101850;8844840
2101;21;1;HF;10467882;2246859;6767601;2172065;6331;2576;0;186238;11381670;2367210;913788
2101;21;1;IDF;15608847;818334;0;53005;6028;5477;0;203705;1086549;268215;-14522298
2101;21;1;N;6161824;1065712;10334722;391982;11289;22404;0;93000;11919109;518675;5757285
2101;21;1;NlleA;10086910;312142;9667094;591561;254398;1318908;0;251230;12395333;2416097;2308423
2101;21;1;O;9209539;132703;3761334;831747;218051;3072983;-210385;122050;7928483;4034446;-1281056
2101;21;1;PACA;9180167;1847434;0;55756;175885;1808478;-7802;154874;4034625;2187191;-5145542
2101;21;1;PDL;6322668;1411953;0;489603;39688;8276;0;70224;2019744;607791;-4302924
2102;21;2;AURA;11483756;539495;12670942;262164;155059;5683641;-620721;171157;18861737;5651300;7377981
2102;21;2;B;4542174;356613;0;433785;26107;110708;-11975;66174;981412;624799;-3560762
2102;21;2;BFC;3839488;214753;0;424355;41331;259471;-3727;60217;996400;781647;-2843088
2102;21;2;CVDL;3738829;125931;13233941;591688;45873;60042;0;77217;14134692;774820;10395863
2102;21;2;GE;8020954;1266315;9408742;1852234;71397;1493236;-179571;174808;14087161;3412104;6066207
2102;21;2;HF;9012809;1732233;5027972;2392731;20103;2162;0;153345;9328546;2568341;315737
2102;21;2;IDF;12790432;612912;0;56829;14297;1123;0;181459;866620;253708;-11923812
2102;21;2;N;5261589;768753;10246825;423013;19849;14034;0;100571;11573045;557467;6311456
2102;21;2;NlleA;7786059;277901;6702512;568419;336994;1221062;0;227165;9334053;2353640;1547994
2102;21;2;O;6566227;121252;3363121;786707;275476;2907285;-242203;111259;7322897;3838524;756670
2102;21;2;PACA;7056775;1311388;0;37754;214503;1716266;-12910;132093;3399094;2087706;-3657681
2102;21;2;PDL;5197180;681358;0;503111;68350;7289;0;61589;1321697;640339;-3875483
2103;21;3;AURA;11954196;583042;14337369;232993;161169;5131668;-550731;190511;20086021;5165610;8131825
2103;21;3;B;4414818;363519;0;382546;9077;113880;-10335;73108;931795;568276;-3483023
2103;21;3;BFC;3852543;190394;0;334029;41484;166422;-4599;57681;785411;595017;-3067132
2103;21;3;CVDL;3609675;125256;12706891;539966;54349;26438;0;86430;13539330;707183;9929655
2103;21;3;GE;8341462;940838;8514927;1461656;159049;1422626;-177051;190071;12512116;3056351;4170654
2103;21;3;HF;9146550;2034911;5816803;2180209;23558;2976;0;176395;10234852;2383138;1088302
2103;21;3;IDF;12915781;560950;0;49685;13703;13098;0;202445;839881;278931;-12075900
2103;21;3;N;5266530;704769;11696349;355864;17949;18427;0;117479;12910837;509719;7644307
2103;21;3;NlleA;7877657;256286;6655038;479185;555308;842422;0;199468;8987707;2076383;1110050
2103;21;3;O;6660012;116838;3707961;788767;368581;2530252;-219747;128013;7420665;3595866;760653
2103;21;3;PACA;7188721;1424454;0;38326;335143;1329558;-10170;147311;3264622;1840168;-3924099
2103;21;3;PDL;5066756;784173;0;421313;56053;6485;0;70357;1338381;554208;-3728375
2104;21;4;AURA;10303645;410668;11261621;189370;348594;3487319;-543381;145475;15299666;3627377;4996021
2104;21;4;B;3701577;28799;0;299809;81599;99564;-11095;63475;562151;533352;-3139426
2104;21;4;BFC;3420051;83180;0;317481;104463;78794;-11071;60640;633487;550307;-2786564
2104;21;4;CVDL;2960714;17413;12019336;455712;136898;8433;0;84497;12722289;685540;9761575
2104;21;4;GE;7274174;1377185;7849339;1150802;183090;1088858;-84915;170812;11735171;2508647;4460997
2104;21;4;HF;8187082;1742785;5073960;1499528;63066;2880;0;150508;8532727;1715982;345645
2104;21;4;IDF;11136921;63770;0;42338;38667;12878;0;200717;358370;294600;-10778551
2104;21;4;N;4563275;297732;8520773;221349;59235;14746;0;91192;9205027;386522;4641752
2104;21;4;NlleA;6606767;28317;6030139;468238;882880;444769;0;220602;8074945;2016489;1468178
2104;21;4;O;5821944;536;3630717;566991;612397;1570282;-181450;121514;6320987;2689734;499043
2104;21;4;PACA;6414744;1160090;0;29242;383020;1039220;-15635;108089;2704026;1543936;-3710718
2104;21;4;PDL;4237280;774764;0;358486;198780;3538;0;72583;1408151;633387;-2829129
2105;21;5;AURA;9768798;73093;13110398;198523;353994;5642970;-641937;152951;18889992;5706501;9121194
2105;21;5;B;3434194;15278;0;428177;71865;99391;-12529;72264;674446;659168;-2759748
2105;21;5;BFC;3261924;61297;0;442572;100852;196874;-17457;62837;846975;785678;-2414949
2105;21;5;CVDL;2723438;8689;9019900;634294;132117;15665;0;94569;9905234;876645;7181796
2105;21;5;GE;6510536;366670;8932956;1763626;181831;1288916;-1522;172433;12704910;3405284;6194374
2105;21;5;HF;7708613;990710;5832006;2152308;69411;2976;0;178691;9226102;2403386;1517489
2105;21;5;IDF;10206182;41382;0;58224;37716;15549;0;181145;334016;292634;-9872166
2105;21;5;N;4098949;286954;10475573;405555;59775;14214;0;118389;11360460;597933;7261511
2105;21;5;NlleA;6322631;32240;5805299;546357;867788;606094;0;257470;8115248;2277709;1792617
2105;21;5;O;5252017;107;1933316;560453;672950;1781591;-286301;105107;4767223;2833800;-484794
2105;21;5;PACA;5896395;374787;0;36082;488527;2217445;-17865;116540;3215516;2840729;-2680879
2105;21;5;PDL;3859217;168969;0;489053;204360;3961;0;79258;945601;776632;-2913616
2106;21;6;AURA;9063380;244947;12894670;170676;371829;5969614;-447005;137176;19341907;6202290;10278527
2106;21;6;B;3006508;11965;0;109975;68681;89346;-12643;70759;338083;326118;-2668425
2106;21;6;BFC;2959832;39782;0;132088;105748;102586;0;61315;441519;401737;-2518313
2106;21;6;CVDL;2310532;7282;9674468;172428;139530;11245;0;76957;10081910;400160;7771378
2106;21;6;GE;6353901;978337;9276550;471601;222826;1746053;-954;174682;12869095;2614208;6515194
2106;21;6;HF;6866719;928812;4688457;650477;70127;2709;0;154228;6494810;877541;-371909
2106;21;6;IDF;9069654;27366;0;14844;37877;13905;0;182655;276647;249281;-8793007
2106;21;6;N;3738212;284139;12423176;91887;50353;18057;0;112995;12980607;273292;9242395
2106;21;6;NlleA;5607194;36782;4639466;193244;855104;444525;0;234064;6403185;1726937;795991
2106;21;6;O;5070440;168;1795468;429066;686623;1411047;-272359;68736;4118749;2323113;-951691
2106;21;6;PACA;5833266;345096;0;23497;477782;2403854;-14895;99812;3335146;2990050;-2498120
2106;21;6;PDL;3479762;73402;0;126293;187348;2409;0;77309;466761;393359;-3013001
2107;21;7;AURA;9265753;131703;12964023;156124;376551;5773193;-362744;179699;19218549;6122823;9952796
2107;21;7;B;3106407;4363;0;238704;76881;93981;-13638;79082;479373;475010;-2627034
2107;21;7;BFC;2949581;44169;0;235324;101451;211407;0;71948;664299;620130;-2285282
2107;21;7;CVDL;2424405;19994;9501912;350241;142598;12614;0;99316;10126675;604769;7702270
2107;21;7;GE;6354627;827114;10964161;957417;218818;1827838;-3800;202891;14994439;3203164;8639812
2107;21;7;HF;6992506;1174545;4870693;1164257;78967;2734;0;168521;7459717;1414479;467211
2107;21;7;IDF;8785177;2137;0;31415;38409;9353;0;230288;311602;309465;-8473575
2107;21;7;N;3656402;292511;10791753;187495;59927;14401;0;102203;11448290;364026;7791888
2107;21;7;NlleA;6054492;35635;5927798;251881;897559;563980;0;264442;7941295;1977862;1886803
2107;21;7;O;5530530;65;1849395;440525;748539;1096363;-269351;114288;3979824;2130364;-1550706
2107;21;7;PACA;6439704;366197;0;26242;536423;1479249;-10477;163682;2561316;2195119;-3878388
2107;21;7;PDL;3636003;106326;0;303021;204067;2669;0;88648;704731;598405;-2931272
2108;21;8;AURA;8468437;23390;13226507;151650;374788;4364709;-547651;165125;17758518;4508621;9290081
2108;21;8;B;2960744;10140;0;205449;67653;90796;-12979;82618;443677;433537;-2517067
2108;21;8;BFC;2676901;36295;0;192364;100945;114027;-7028;52287;488890;452595;-2188011
2108;21;8;CVDL;2404094;13603;10877059;267750;129061;4795;0;77831;11370099;479437;8966005
2108;21;8;GE;5709624;338072;10826361;742406;195324;1772100;-17700;202337;14058900;2894467;8349276
2108;21;8;HF;6508424;722052;4747343;1237422;69087;2973;0;167272;6946149;1476754;437725
2108;21;8;IDF;7985234;10222;0;25725;30989;1494;0;172117;240547;230325;-7744687
2108;21;8;N;3458037;279159;10330331;209643;49394;12114;0;100649;10981290;371800;7523253
2108;21;8;NlleA;6024019;43178;6183914;326624;873669;224337;0;261280;7913002;1685910;1888983
2108;21;8;O;5370434;29;1797984;336516;733978;969692;-162452;129380;3805127;2007114;-1565307
2108;21;8;PACA;6208511;98551;0;27135;503193;1129154;-11076;148674;1895631;1797080;-4312880
2108;21;8;PDL;3321581;125609;0;187636;178986;677;0;68060;560968;435359;-2760613
2109;21;9;AURA;9074704;198645;12897988;123062;312008;3047738;-547510;155026;16186957;3090324;7112253
2109;21;9;B;3039240;10660;0;200541;61913;88417;-11397;73873;424007;413347;-2615233
2109;21;9;BFC;2977056;74668;0;168119;94781;93424;-13905;53947;471034;396366;-2506022
2109;21;9;CVDL;2423008;1934;11876398;261840;129740;4183;0;81093;12355188;476856;9932180
2109;21;9;GE;6409207;955716;9466019;606181;212021;1283685;-69877;205047;12658792;2237057;6249585
2109;21;9;HF;7141552;1133916;3657849;872671;70284;1995;0;140710;5877425;1085660;-1264127
2109;21;9;IDF;9074128;4613;0;25822;39181;6009;0;236792;312417;307804;-8761711
2109;21;9;N;3674475;260488;12743188;166170;47679;10805;0;90234;13318564;314888;9644089
2109;21;9;NlleA;5931862;50466;5966792;236260;729263;401080;0;243517;7627378;1610120;1695516
2109;21;9;O;5082645;433;1397401;340592;556808;832565;-132743;103780;3098836;1701002;-1983809
2109;21;9;PACA;5778597;360419;0;22769;386795;976981;-5836;119977;1861105;1500686;-3917492
2109;21;9;PDL;3554803;1139906;0;225028;168326;143;0;81488;1614891;474985;-1939912
2110;21;10;AURA;10458582;227351;16069059;290926;267868;2782097;-740251;153017;19050067;2753657;8591485
2110;21;10;B;3432690;48460;0;353331;48056;85686;-10602;65591;590522;542062;-2842168
2110;21;10;BFC;3434447;87488;0;338532;83625;89959;-13270;68032;654366;566878;-2780081
2110;21;10;CVDL;2869929;15081;10607567;524340;114072;5073;0;86094;11352227;729579;8482298
2110;21;10;GE;7500328;1094820;10432787;1395025;147837;950806;-187870;195336;14028741;2501134;6528413
2110;21;10;HF;8193847;1156359;3897665;2112124;47203;1589;0;154232;7369172;2315148;-824675
2110;21;10;IDF;10948197;67508;0;56602;29380;10627;0;241309;405426;337918;-10542771
2110;21;10;N;4226634;260994;12243506;350062;34026;12923;0;108434;13009945;505445;8783311
2110;21;10;NlleA;6591449;92064;6157639;490150;677702;301988;0;218728;7938271;1688568;1346822
2110;21;10;O;5506298;2765;1758561;572974;529552;930447;-323918;123420;3593801;1832475;-1912497
2110;21;10;PACA;5969206;616818;0;31806;344864;835218;-15373;111089;1924422;1307604;-4044784
2110;21;10;PDL;3985509;1317642;0;363198;134219;2188;0;80083;1897330;579688;-2088179
